{
    "size": [
        240,
        100
    ],
    "blocks": [
        "SSSSSSSSSSSSSSSSSSSSSSSSSSSSSSSSSSSSSSSSSSSSSSSSSSSSSSSSSSSSSSSSSSSSSSSSSSSSSSSSSSSSSSSSSSSSSSSSSSSSSSSSSSSSSSSSSSSSSSSSSSSSSSSSSSSSSSSSSSSSSSSSSSSSSSSSSSSSSSSSSSSSSSSSSSSSSSSSSSSSSSSSSSSSSSSSSSSSSSSSSSSSSSSSSSSSSSSSSSSSSSSSSSSSSSSSSSSSSSSS",
        "S..............................................................................................................................................................................................................................................S",
        "S..............................................................................................................................................................................................................................................S",
        "S..............................................................................................................................................................................................................................................S",
        "S..............................................................................................................................................................................................................................................S",
        "S..............................................................................................................................................................................................................................................S",
        "S..............................................................................................................................................................................................................................................S",
        "S..............................................................................................................................................................................................................................................S",
        "S.........................................................................................F....................................................................................................................................................S",
        "S..........................................................................................FFF....................................................F............................................................................................S",
        "S.............................................................................................F..................................................F..............................................FF.............................................S",
        "S.............................................................................................................................................F.F.................................................F............................................S",
        "S...........................................................................................................................................F.......................................................FF.........................................S",
        "S.....................FFFF.................................................................................................................F...........................................................F.......................................S",
        "S..........................FFF..........................................................................................................................................................................FF.....................................S",
        "S.............................FF..........................................F.............................................................F................................................................FF....................................S",
        "S...............................F.......................................FF............................................................FF..................................................................FF...................................S",
        "S................................F.....................................F.............................................................F.........................................................................................................S",
        "S.................................F.................................FF..............................................................F..........................................................................................................S",
        "S..................................................................F....................................DDH....................................................................................................................................S",
        "S................................................................FF..............................DDDHHDDDDD....S...............................................................................................................................S",
        "S................................................................................................SDDDDDDDDDDDDSS...............................................................................................................................S",
        "S.................................................................................................SSSDDDDDDDSS.................................................................................................................................S",
        "S...................................................................................................SSSSDDSSS.................................................H............H...................................................................S",
        "S......................................................................................................SDSS.................................................DDD............D...................................................................S",
        "S......................................................................................................SSS..................................................SSDDD.HDDDDDDDDDSS..........................................FF.....................S",
        "S.......................................................................................................SS....................................................SSDDDDDDDDDDDSS..........................................FF......................S",
        "S...............................................................................................................................................................SSDDDDDDDSS...........................................F........................S",
        "S.................................................................................................................................................................SDDDDDSS...........................................F.........................S",
        "S.................................................................................................................................................................SSDDDDS..........................................F...........................S",
        "S..................................................................................................................................................................SSDSSS........................................F.............................S",
        "S....................................................................................................................................................................SS.........................................F..............................S",
        "S........................................................................................................................................H.B..................................................................F................................S",
        "S.................................................................................HDDD...........................................DHDDD..SDSSSS..DDD..........................................................F.................................S",
        "S................................................FFFF.F...........................DD>.............................................DD.....SSSS......D.......................................................FF..................................S",
        "S......................................................F.....................S....DSS......D........................H......DD.............SD......BD...........................................................................................S",
        "S......................................................FF...............H..................DD...............HH.....DDD....................D......DDD...........................................................................................S",
        "S.......................................................F..............DDD.................SDDH......H.....DDDD.....D.............................DD...........................................................................................S",
        "S........................................................F..............D..................SSDDD...DDDDD....DSD...................................<D...........................................................................................S",
        "S.......................................................................D...........................DDD.....DD...................................HDD...................H.............H.........................................................S",
        "S.......................................................................DB...........................DS......D...................................DDD..................DDD...........DDD..DD....................................................S",
        "S.......................................................................DDDD.........................D...........................................DD...................DLD................DD....................................................S",
        "S......................................................................DD.........................................................................D...................DLD...............DDD....................................................S",
        "S.....................................................................HDD.........................................................................DB..................DSDBDD............DSD....................................................S",
        "S.....................................................................DSD.........................................................................DD.............H....SSSS.............DDSD....................................................S",
        "S.......................................................F.............DSDDD..............................................................................H......DDD..................HDSSSD....................................................S",
        "S................F.................C..................F................SSD.............................................................................DDDDD......S..................DDSSSDH...................................................S",
        "S...............FF.................D.................FF................DSD............................................................................................................DDSSDD...................................................S",
        "S..............FF..................SLLLLS..............................DD..............................................................................................................DDSDD...................................................S",
        "S.............FF..................SSLLLSS..............................DDD..............................................................................................................DDSDDDDD...............................................S",
        "S.........FFF.......................SLSS................................DD..............F...............................................................F................................DDDDSSS...............................................S",
        "S...................................SSS.................................D..............F..............................................................FF...................................DSSDD...............................................S",
        "S.....................................S................................................F............................................................FF.......................................S.....SSSSSSSS....................................S",
        "S......................................................................................F..........................................................................................................SSLLLLLLS....SS..............................S",
        "S.......................................................................H....................................................F.....................................................................SSLSSSS.....SS..............................S",
        "S.................................................................D....DDD..........................................................................................................................SLLSSS.....SS....................<SSSSSSSSSS",
        "S..........................................................H.H..........V..................................................F........................................................................SSLSS......SS..............................S",
        "S................................................B........DDDDD......................................................................................................................................SSSS......SS..............................S",
        "S................................................D.....D...D.D..........................................................FF............................................................................S........SS..........................<SSSS",
        "S................................................D.....D................................................................F......................................................................................SS...............F..............S",
        "S................................................D.....DD......................................................................................................................................................SS...........F.FFF..............S",
        "S..........D....................................DD.....D.......................................................................................................................................................SS......FF.F....................S",
        "S.......H.DDD....H..H............................D.....D>......................................................................................................................................................SS............................<SS",
        "S.......DDDDD...DDDDDD...........................D.....DD..............................................................................................................................FF......................SS..............................S",
        "S.......SSSDDDHDDSSSSSS..........................D.....D.............................................................................................................................FF........................SS.........................<SSSSS",
        "S.........SDDDDDSS................DH............HD.....D...........................................................................................................................F...........................SS..............................S",
        "S.........SSDDDSS................DDD...........DDD.....D.......................................................................................................................................................SS..............................S",
        "S..........SSSSS..................V..............D.....D..........................................................................................................................F............................SS..............................S",
        "S...........SS.........................................D..........................................................................................................................F............................SS..............................S",
        "S................................................................................................................................................................................F.............................SS..............................S",
        "S....................................................H...........................................................................................................................F.............................SS...........................<SSS",
        "S..............................................HHDSDDD.........................................................................................................................................................SS..............................S",
        "S...........................................DDDDDDDSSS.........................................................................................................................................................SS..............................S",
        "S.............................H........H.....SSLDDDSS..........................................................................................................................................................................................S",
        "S............................DDSS....SSDSS....SSDSS.....................................F.................................................................................................................................................<SSSSS",
        "S>..................D...H....SSS.....DDDD......SLS.....................................F.F.....................................................................................................................................................S",
        "S...............H...DDDDDDD...S.......DD.......SSS....................................F.F.F....................................................................................................................HHH.....B.......................S",
        "S.............DDDSD..SSSSS.............D........SS...................................F.....F..................................................................................................................DDDDDDDDDDBH.....................S",
        "SH.....H.......SSS....SSS........................S..................................F.......F.....................................................................................................................SDDDDSDDDD..................SS",
        "SSSDDDDDDSD.....S......S...........................................................F.........F....................................................................................................................SSDDSS>.....................SS",
        "SSSSSDDSSS........................................................................F...........F....................................................................................................................SSS.......F................SS",
        "S..SSSDS..........................................................................F...........F....................................................................................................................SS........F.................S",
        "S....S............................................................................FF.........FF....................................................................................................................S......F..F..F..............S",
        "S................F..................................................................F.DDDDD.F..............................................................................................................................F...F...............S",
        "S...............F....................................................................F.....F................................................................................................................................FFF................S",
        "S..............F...........................................F..........................FF.FF..................................................................................................................................F.................S",
        "S..............F........................................................................F......................................................................................................................................................S",
        "S........................................................F.....................................................................................................................................................................................S",
        "S...............................................F.F..F.F.......................................................................................................................................................................................S",
        "S..............................................................................................................................................................................................................................................S",
        "S............................................................................................................................................................................................................................................EHS",
        "S.........................................................................................................................................................................................................................................DDDDDS",
        "S..............................................................................................................................................................................................................................................S",
        "S..............................................................................................................................................................................................................................................S",
        "S..............................................................................................................................................................................................................................................S",
        "S..............................................................................................................................................................................................................................................S",
        "S..............................................................................................................................................................................................................................................S",
        "S..............................................................................................................................................................................................................................................S",
        "S..............................................................................................................................................................................................................................................S",
        "BBBBBBBBBBBBBBBBBBBBBBBBBBBBBBBBBBBBBBBBBBBBBBBBBBBBBBBBBBBBBBBBBBBBBBBBBBBBBBBBBBBBBBBBBBBBBBBBBBBBBBBBBBBBBBBBBBBBBBBBBBBBBBBBBBBBBBBBBBBBBBBBBBBBBBBBBBBBBBBBBBBBBBBBBBBBBBBBBBBBBBBBBBBBBBBBBBBBBBBBBBBBBBBBBBBBBBBBBBBBBBBBBBBBBBBBBBBBBBBB"
    ],
    "objects": [
        {
            "type": "AK47",
            "pos": [
                88,
                82
            ]
        },
        {
            "type": "Spawn",
            "pos": [
                3,
                78
            ]
        }
    ],
    "version": 2
}