{
    "size": [
        120,
        40
    ],
    "blocks": [
        "SSSSSSSSSSSSSSSSSSSSSSSSSSSSSSSSSSSSSSSSSSSSSSSSSSSSSSSSSSSSSSSSSSSSSSSSSSSSSSSSSSSSSSSSSSSSSSSSSSSSSSSSSSSSSSSSSSSSSSSS",
        "S......................................................................................................................S",
        "S......................................................................................................................S",
        "S......................................................................................................................S",
        "S......................................................................................................................S",
        "S......................................................................................................................S",
        "S......................................................................................................................S",
        "S......................................................................................................................S",
        "S......................................................................................................................S",
        "S......................................................................................................................S",
        "S......................................................................................................................S",
        "S......................................................................................................................S",
        "S......................................................................................................................S",
        "S......................................................................................................................S",
        "S......................................................................................................................S",
        "S......................................................................................................................S",
        "S.................F....................................................................................................S",
        "S................F......................F..............................................................................S",
        "S...............F.....................FFF..............................................................................S",
        "S..............F.................F....FFF..............................C.................F.............................S",
        "S............F..................FFFFFFFFF.F..................F...........................FF............................S",
        "S...........FF...................FFFFFFFFFFFF...............F..............................FF..............FF..........S",
        "S.................................FFFF..FF.F................................................FF.............F...........S",
        "S.................................F....................................................................................S",
        "S.................................F....................................................................................S",
        "S......................................................................................................................S",
        "S............................................................................F.........................................S",
        "S............................................................................FFF.......................................S",
        "S......................................................................................................................S",
        "S......................................................................................................................S",
        "S......................................................................................................................S",
        "SDDH...B.................................................................................HD............................S",
        "SDDDDDDDDDDD>.........DDD^...........D..D............H...H...H..........D>........DH.....DD.........DD.B...DH........EHS",
        "SDDDDDDDDDSDLDDDDD.B..DDDDDDDDDH....<D..DD>........DDDD^DDD^DDD..DDDD...DDDDDH...DDDDD.B.DD>.......HDDDDLLDDD....D..DDDS",
        "SSSDDSSDDDSDLDDDDDDDDDDSSDDDDSDDDDDDDD^DDDDDDDDDLLDDDDDDDDDDDDDD^DDDDD^DDSSDDDDDDDDDDDDDDDDD...DLDDDDDDDDDDDDD^DDDDDDDDS",
        "SSSSSSSSSSSSLLLDDSDDDSSSDDDDSSDDDDDSDDDDDDDDSSDDDDDDDDSDDDDDDSSDDDDSSDDDDSSSDDDDDDDDDDDSSDDDDDDDDDDDDDDSSDDDSDDDDDDDDDDS",
        "SSSSSSSSSSLLLLLLSSDDSSSDDDSSSSSSDSSSSSSDSSDDSSSDSSSSSDSSSSSSSSSSSSSSSSDDSSSSSSDDDDDDSSSSSSSSDDDDDDSSSSSSSDDDSSSDDDDDSSSS",
        "SSSSLLLLLLLLLLLLLSSSSSSSSSSSSSSSSSSSSSSSSSSSSSSSSSSSSSSSSSSSSSSSSSSSSSSSSSSSSSSSSSSSSSSSSSSSSSSSSSSSSSSSSSSSSSSSSSSSSSSS",
        "SSSLLLSSLLLLLLLLSSSSSSSSSSSSSSSSSSSSSSSSSSSSSSSSSSSSSSSSSSSSSSSSSSSSSSSSSSSSSSSSSSSSSSSSSSSSSSSSSSSSSSSSSSSSSSSSSSSSSSSS",
        "BBBBBBBBBBBBBBBBBBBBBBBBBBBBBBBBBBBBBBBBBBBBBBBBBBBBBBBBBBBBBBBBBBBBBBBBBBBBBBBBBBBBBBBBBBBBBBBBBBBBBBBBBBBBBBBBBBBBBBBB"
    ],
    "objects": [
        {
            "type": "Spawn",
            "pos": [
                2,
                29
            ]
        },
        {
            "type": "AK47",
            "pos": [
                46,
                33
            ]
        }
    ],
    "version": 2
}