{
    "size": [
        120,
        40
    ],
    "blocks": [
        "SSSSSSSSSSSSSSSSSSSSSSSSSSSSSSSSSSSSSSSSSSSSSSSSSSSSSSSSSSSSSSSSSSSSSSSSSSSSSSSSSSSSSSSSSSSSSSSSSSSSSSSSSSSSSSSSSSSSSSSS",
        "S.....DSSD.............................................................................................................S",
        "S.....DSSD.................................H.............H....................DD.......................................S",
        "S.....DDSD.................SDDDD.DDDDH.DDDDD.DDDDDDDDDDDDD...................HD.......H................................S",
        "S......DDD......D..........SSDDDDDDDDDDDDDDDDDDDDDDSSSSSSDD..................DD......DD........................DD......S",
        "S.E.....SD..................SSSSDDDDDDDDDSSSSSSSSSSSSSS......................DD.....DDDDDDD.................H.DDS......S",
        "SSDS................D....D...SSSSSDDDSSSSSSSSSSSSSS..........................DD....DDSSSSSS.................DDDSS......S",
        "SLSS........DD.................SSSSSSSSSSSSS.................D................D....FSSSSSFF.................FFSSF......S",
        "SLSF..D.........................SSSSSSS..SS...................................D.....FFFSFF.....D.............FSF...S...S",
        "SLF......................................................D....................D.......FF......................F...SS...S",
        "SL............................................................................D....................................SS..S",
        "SL.......D..................................................DD................D....................D...............DSS.S",
        "SL..........................................................SDD...............D.........H..........................DDS.S",
        "SL...........................................................SDD..............D......DDDD...........................DDSS",
        "SL.................................F.........................SSD..............D......<DSD............................DSS",
        "SL................................F..........................SS...DDD................DDSD..............D.............DDS",
        "SL.............................F.............................S.......................DDSD....................B.......HDS",
        "SL........................FF.F.......................F..................DD..........^DSSD..^...............DDDD......DSS",
        "SL..................................................F..............................^DDSSD^^D...............FSDDD.....DSS",
        "SL................................................F.........................D....DDDSDSSDDDD...............FSFFF.....DSS",
        "SL........................................FFF.F.F..................................FSSSSSSSS................F.F......DSS",
        "SL..................................................................................FFFSSSSF.........................DSS",
        "SL.....................................................................................FSFF.........................DDSS",
        "SL......................................................................................F...............C...........DSSS",
        "SL.................................................................................................................DSSFS",
        "SL.................................................................................................................SSF.S",
        "SL.................................................................................................................FFF.S",
        "SLL..............H..................................H.......................H...................................DDS.FF.S",
        "SLL..........DDDDDSS...D.D.D.D.D.D.D.D..D..D..D..D..D..D...D...D...D...D....D....D....D.....D......D.........DDDDSS..F.S",
        "SLL..........FSSSSFF.........................................................................................FFSSSF....S",
        "SLL..........FFSSFF...........................................................................................FFSF.....S",
        "SLL...........FFF..............................................................................................FFF.....S",
        "SLL............FF...............................................................................................F......S",
        "SLLL..........................................................................^........................................S",
        "SLLL.........................................................................FDF.......................................S",
        "SLLLL.........................................................................F........................................S",
        "SLLLL..................................................................................................................S",
        "SLLLL..................................................................................................................S",
        "SLLLLL.................................................................................................................S",
        "BBBBBBBBBBBBBBBBBBBBBBBBBBBBBBBBBBBBBBBBBBBBBBBBBBBBBBBBBBBBBBBBBBBBBBBBBBBBBBBBBBBBBBBBBBBBBBBBBBBBBBBBBBBBBBBBBBBBBBBB"
    ],
    "objects": [
        {
            "type": "AK47",
            "pos": [
                86,
                12
            ]
        },
        {
            "type": "Spawn",
            "pos": [
                14,
                26
            ]
        }
    ],
    "version": 2
}