{
    "size": [
        84,
        40
    ],
    "blocks": [
        "SSSSSSSSSSSSSSSSSSSSSSSSSSSSSSSSSSSSSSSSSSSSSSSSSSSSSSSSSSSSSSSSSSSSSSSSSSSSSSSSSSSS",
        "SDDDDDDDDDDDDDDDDDDDDDDDDDDDDDDDDDDDDDDDDDDDDDDDDSDSDDDDDSSSDDDDDDDDDDDDDDDDDDDSSSSS",
        "SDDDDDDDDSSSDD...DDSSSDDDDDDDSSSSSDD............DSSSDDDDSSSSDDDDDDDDDDDDDDDDDDSSSSSS",
        "SDDDDDDDSSLSSD...DSSLSSDDDDDDSSSSSSD............DDSSSDDDS..DDDSSDDDDDDDDDDDDDDSDSSSS",
        "SDDDDDDDSLLLSD...DSLLLSDDDDDSSSSSSDD...DDDDD......DSDDDD...DDDSSSD.DDDDDDSDDDDDDDSSS",
        "SDDDDDDDSLLLSD...DSLLLSDDDDDSSSSLSDD..DDSSSSD......DDSDDDD.SDDDS....SSDSSSSDDDDDDDDS",
        "SDDDDDDDSLLLSD...DSLLLSDDDSSSSSLLSDD..DDDDDSSD......DSSDDSSSDDDS..DSSDSSDDSSSDDDDDDS",
        "SDDDDDDDSLLLSD...DSLLLSDDDSSSSLLLSDD..D...DDDD......DSSDDSSDDDD...SSSSSSSDDDDDDDDDDS",
        "SDDDDDDDSSLSSD...DSSLSSDDDSSSSSLLLSD........DLLLDD..DDSDSSSSDD....SSSSDSSDDDDDDDDDDS",
        "SDDDDDDDDSSSDD...DDSSSDDDDDSSSLSLLSD.......DDDDDDD..DDSS..SSDD....DSSDDDSDDSSSSSDDDS",
        "SDDDDDDDDDDDDD...DDDDDDDDDDDDSLSSSSD....D..DDSDSDD..DDSS..SDDSS...DDDDSSSDDSSSDSDDDS",
        "SDDDSSSDDDDDDD...DDDDDDDSSSDDSSLSSDD...DD..DDSDSDD..DDDD..SDDDS..DDDDDSDDDDDSSDSDDDS",
        "SDDDSLSSSDDDDD...DDDDDSSSLSDDSLSSSDD...D...DSDDDSD..DD...DDDDDD.SSDDDDDDDDDSSSSSDDDS",
        "SDDDSLLLSSSDDD...DDDDSSLLLSDDSSSSSSDBBBD...DDSSSD....DDD...DDSDDDSSD...DDDSSSDSDDDDS",
        "SDDDSSSLLLSSSD...DSSSLLLSSSDDDDDDSSDDDDD...DDDDD.....DDDS.DDDSDDDSS.DDDDDSSSDSDDDDDS",
        "SDDDDDSSSLLLSD...DSLLLSSSDDDDDDDDSSD........D........DDD..SSSSDDD.....DDDSSSSSDDDDDS",
        "SDSSDDDDSSSLLD...DLLSSSDDDDDD...DDDD......^.D........DSDDSSSSSDDSSS..DDDDSDDDDDDDDDS",
        "SDSSSDDDDDSSSS...SSSSDDDDDD.......DD..DDDDDDD....DLLLDSSDSSDSDD..DS.SSDDDDDDDDDDDDDS",
        "SDSSSSSDDDDDD....DDDDDDDD.........DD...DD...D..DDDDSDDSSDSDSSDDD.DSSSDSSDDDDDSSSDDDS",
        "SDDSDDSSSSDDD....DDDDDDD...........D........D...DSSSSSSSDDSSSD.D.DSDSSSS.DDDSSSSDDDS",
        "SDDSSSDDDDDDDD....DDD.......DDD....D........D...DDDDSSSSSDDSD.D..D...SSD..DDDDSDDDDS",
        "SDDSSDSDDDDDD.....DD.......DD......DD..DD...D......DDDD..D.SDD.D....SSSS.DDSSSSDDDDS",
        "SDDSDSSSDDD......DD.......DD......DDD..D....D.......DDD.....DDDDS..DSSSSDDDDSSSSDDDS",
        "SDDSSSDDD........D........D.......DSD..D....DD.......DSD...DDDDSDS..SSSD..DSSSDSSSDS",
        "SDDSSDD.........DD.......DD......DDSD..D....DDD......DSS..DDDDDDDDDDDD....DSSSSSSDDS",
        "SDDDDD.........DD.......DD......DDSDD..D....<SDLD..DLDD...DDSSDDDDDDDDD...DDSDSDDDDS",
        "SDDDDD.......DDD.....D..D......DDDSSD..D....DSDDD..DDDDDDDDDSSSDDDDSDSSDD.DDSSSSDDDS",
        "SDDDSS.....D.D......DSDDD.....DDSSSSD..D....DSD......DDDDDDSSSSSSDDSSSDDS.DDDSSDDDDS",
        "SDDSS....DDDDD....DDSSSD.....DDSSSSSD..D....DSDD....DSDDDDDDDSSSD.DDS..DS...DSSDDDDS",
        "SDDS....DD.........DDDDDD....DDDSSSSD..D....DSSDD..DSSD..DDDDSS....SS..SSSDDDDDDDDDS",
        "SSS.....DD..............D.....DDDSSSD..D....DSDD....DD.....DDDDDDD.....SSSDSDDDDSDDS",
        "SDSS.....DDDD...........DD.......DSSD..D....<S......D.......DDDDSS.....SSSDSDDDDSSSS",
        "SDDS........DDDDD........DD......DSDD^^D....DD......D...D...DDDDDD.....DSSDSSDDDSSSS",
        "SDDDDD...........DDDD......D.....DSDDDDD....DD..DLLDD...D...DDSDSDSS...SSSSSSDDDSSDS",
        "SSDDDD.....................D.....DDD........DD...DDD...DDD..DDSSSSSDS..DDDDSDDDDDSSS",
        "SSDDDDDD...................D................DS..............DDDDSSSSDDDSSSSSSSSDDDSS",
        "SSSDDDDDD.................DD...............DSSD.............DDDDSSSSSSSSSSSSSSSDDDDS",
        "SSSSSSDDDDDD.............DD...............DSDSSD.........E.DDDDDDSSSSSSSDDDDDDDDDDDS",
        "SSSSSSSDDDDDDDDDDDDDDDDDDDDDDDDDDDDDDDDDDDDDDDDDDDDDDDDDDDDDDDDDDDDDDDDDDDDDDDDDDDDS",
        "BBBBBBBBBBBBBBBBBBBBBBBBBBBBBBBBBBBBBBBBBBBBBBBBBBBBBBBBBBBBBBBBBBBBBBBBBBBBBBBBBBBB"
    ],
    "objects": [
        {
            "type": "AK47",
            "pos": [
                59,
                36
            ]
        },
        {
            "type": "Spawn",
            "pos": [
                53,
                35
            ]
        }
    ],
    "version": 2
}