{
    "size": [
        120,
        40
    ],
    "blocks": [
        "SSSSSSSSSSSSSSSSSSSSSSSSSSSSSSSSSSSSSSSSSSSSSSSSSSSSSSSSSSSSSSSSSSSSSSSSSSSSSSSSSSSSSSSSSSSSSSSSSSSSSSSSSSSSSSSSSSSSSSSS",
        "S......................................................................................................................S",
        "S......................................................................................................................S",
        "S......................................................................................................................S",
        "S......................................................................................................................S",
        "S......................................................................................................................S",
        "S......................................................................................................................S",
        "S......................................................................................................................S",
        "S......................................................................................................................S",
        "S......................................................................................................................S",
        "S......................................................................................................................S",
        "S......................................................................................................................S",
        "S......................................................................................................................S",
        "S......................................................................................................................S",
        "S......................................................................................................................S",
        "S......................................................................................................................S",
        "S......................................................................................................................S",
        "S......................................................................................................................S",
        "S......................................................................................................................S",
        "S......................................................................................................................S",
        "S......................................................................................................................S",
        "S......................................................................................................................S",
        "S......................................................................................................................S",
        "S......................................................................................................................S",
        "S..........................................................K...........................................................S",
        "S........................................................BD.D..........................................................S",
        "S........................................................SSSSS........................................................<S",
        "S........................................................S.V.S.........................................................S",
        "S......................................................................................................................S",
        "S...................................................DDD................................................................S",
        "S......................................................................................................................S",
        "S......................................................................................................................S",
        "S......................................................................................................................S",
        "S....................................................................................................................E.S",
        "SDDDDDDDDDD..B..DDDDDDDDDDDDD...........DDDDD...DDDDDDDDDDDDDDDDDDDDDD^DDDDDDDD>...............DDDDDDDDDDDDDDDDDDDDDDDDS",
        "SDDDDDDDDDDDDDDDDDDDDDDDDDDDDD..........DDDDDD^DDDDDDDDDDDDDDDDDDDDDDDDDDDDDDDDDDDDDDDDDDDDDDDDDDDDDDDDDDDDDDDDDDDDDDDDS",
        "SDDDDDDDDDDDDDDDDDDDDDDDDDDDDDD........DDDDDDDDDDDDDDDDDDDDDDDDDDDDDDDDDDDDDDDDDDDDDDDDDDDDDDDDDDDDDDDDDDDDDDDDDDDDDDDDS",
        "SSSSSSSSSSSSSSSSSSSSSSSSSSSSSSSS......SSSSSSSSSSSSSSSSSSSSSSSSSSSSSSSSSSSSSSSSSSSSSSSSSSSSSSSSSSSSSSSSSSSSSSSSSSSSSSSSSS",
        "SSSSSSSSSSSSSSSSSSSSSSSSSSSSSSSSS....SSSSSSSSSSSSSSSSSSSSSSSSSSSSSSSSSSSSSSSSSSSSSSSSSSSSSSSSSSSSSSSSSSSSSSSSSSSSSSSSSSS",
        "BBBBBBBBBBBBBBBBBBBBBBBBBBBBBBBBBBBBBBBBBBBBBBBBBBBBBBBBBBBBBBBBBBBBBBBBBBBBBBBBBBBBBBBBBBBBBBBBBBBBBBBBBBBBBBBBBBBBBBBB"
    ],
    "objects": [
        {
            "type": "Spawn",
            "pos": [
                2,
                32
            ]
        }
    ],
    "version": 2
}