{
    "size": [
        120,
        40
    ],
    "blocks": [
        "SSSSSSSSSSSSSSSSSSSSSSSSSSSSSSSSSSSSSSSSSSSSSSSSSSSSSSSSSSSSSSSSSSSSSSSSSSSSSSSSSSSSSSSSSSSSSSSSSSSSSSSSSSSSSSSSSSSSSSSS",
        "S.....DSSD.............................................................................................................S",
        "S.....DSSD.................................H.............H....................DD.......................................S",
        "S.....DDSD.................SDDDD.DDDDH.DDDDD.DDDDDDDDDDDDD...................HD.......H................................S",
        "S......DDD......D..........SSDDDDDDDDDDDDDDDDDDDDDDSSSSSSDD..................DD......DD........................DD......S",
        "S.E.....SD..................SSSSDDDDDDDDDSSSSSSSSSSSSSS......................DD.....DDDDDDD.................H.DDS......S",
        "SSDS................D....D...SSSSSDDDSSSSSSSSSSSSSS..........................DD....DDSSSSSS.................DDDSS......S",
        "SFSS........D..................SSSSSSSSSSSSS.................D................D....FSSSSSFF.................FFSSF......S",
        "S.SF..D.........................SSSSSSS..SS...................................D.....FFFSFF.....D.............FSF...S...S",
        "S.F......................................................D....................D.......FF......................F...SS...S",
        "S.............................................................................D....................................SS..S",
        "S........D..................................................DD................D....................D...............DSS.S",
        "S...........................................................SDD...............D.........H..........................DDS.S",
        "S............................................................SDD..............D......DDDD...........................DDSS",
        "S............................................................SSD..............D......<DSD............................DSS",
        "S............................................................SS...DDD................DDSD..............D.............DDS",
        "S............................................................S.......................DDSD....................B.......HDS",
        "S.......................................................................DD..........^DSSD..^...............DDDD......DSS",
        "S..................................................................................^DDSSD^^D...............FSDDD.....DSS",
        "S...........................................................................D....DDDSDSSDDDD...............FSFFF.....DSS",
        "S..................................................................................FSSSSSSSS................F.F......DSS",
        "S...................................................................................FFFSSSSF.........................DSS",
        "S......................................................................................FSFF.........................DDSS",
        "S.......................................................................................F...............C...........DSSS",
        "S..................................................................................................................DSSFS",
        "S..................................................................................................................SSF.S",
        "S..................................................................................................................FFF.S",
        "S................H..................................H.......................H...................................DDS.FF.S",
        "S............DDDDDSS...D.D.D.D.D.D.D.D..D..D..D..D..D..D...D...D...D...D....D....D....D.....D......D.........DDDDSS..F.S",
        "S............FSSSSFF.........................................................................................FFSSSF....S",
        "S............FFSSFF...........................................................................................FFSF.....S",
        "S.............FFF..............................................................................................FFF.....S",
        "S..............FF...............................................................................................F......S",
        "S.............................................................................^........................................S",
        "S............................................................................FDF.......................................S",
        "S.............................................................................F........................................S",
        "S......................................................................................................................S",
        "S......................................................................................................................S",
        "S......................................................................................................................S",
        "BBBBBBBBBBBBBBBBBBBBBBBBBBBBBBBBBBBBBBBBBBBBBBBBBBBBBBBBBBBBBBBBBBBBBBBBBBBBBBBBBBBBBBBBBBBBBBBBBBBBBBBBBBBBBBBBBBBBBBBB"
    ],
    "objects": [
        {
            "type": "AK47",
            "pos": [
                86,
                12
            ]
        },
        {
            "type": "Spawn",
            "pos": [
                14,
                27
            ]
        }
    ],
    "version": 2
}