{
    "size": [
        240,
        100
    ],
    "blocks": [
        "SSSSSSSSSSSSSSSSSSSSSSSSSSSSSSSSSSSSSSSSSSSSSSSSSSSSSSSSSSSSSSSSSSSSSSSSSSSSSSSSSSSSSSSSSSSSSSSSSSSSSSSSSSSSSSSSSSSSSSSSSSSSSSSSSSSSSSSSSSSSSSSSSSSSSSSSSSSSSSSSSSSSSSSSSSSSSSSSSSSSSSSSSSSSSSSSSSSSSSSSSSSSSSSSSSSSSSSSSSSSSSSSSSSSSSSSSSSSSSSS",
        "S..............................................................................................................................................................................................................................................S",
        "S..............................................................................................................................................................................................................................................S",
        "S..............................................................................................................................................................................................................................................S",
        "S..............................................................................................................................................................................................................................................S",
        "S..............................................................................................................................................................................................................................................S",
        "S..............................................................................................................................................................................................................................................S",
        "S..............................................................................................................................................................................................................................................S",
        "S..............................................................................................................................................................................................................................................S",
        "S..............................................................................................................................................................................................................................................S",
        "S..............................................................................................................................................................................................................................................S",
        "S..............................................................................................................................................................................................................................................S",
        "S..............................................................................................................................................................................................................................................S",
        "S..............................................................................................................................................................................................................................................S",
        "S..............................................................................................................................................................................................................................................S",
        "S..............................................................................................................................................................................................................................................S",
        "S..............................................................................................................................................................................................................................................S",
        "S..............................................................................................................................................................................................................................................S",
        "S..............................................................................................................................................................................................................................................S",
        "S.......................................................................................................DDH....................................................................................................................................S",
        "S................................................................................................DDDHHDDDDD....S...............................................................................................................................S",
        "S................................................................................................SDDDDDDDDDDDDSS...............................................................................................................................S",
        "S.................................................................................................SSSDDDDDDDSS.................................................................................................................................S",
        "S...................................................................................................SSSSDDSSS.................................................H............H...................................................................S",
        "S......................................................................................................SDSS.................................................DDD............D...................................................................S",
        "S......................................................................................................SSS..................................................SSDDD.HDDDDDDDDDSS.................................................................S",
        "S.......................................................................................................SS....................................................SSDDDDDDDDDDDSS..................................................................S",
        "S...............................................................................................................................................................SSDDDDDDDSS....................................................................S",
        "S.................................................................................................................................................................SDDDDDSS.....................................................................S",
        "S.................................................................................................................................................................SSDDDDS......................................................................S",
        "S..................................................................................................................................................................SSDSSS......................................................................S",
        "S....................................................................................................................................................................SS........................................................................S",
        "S........................................................................................................................................H.B...................................................................................................S",
        "S.................................................................................HDDD...........................................DHDDD..SDSSSS..DDD............................................................................................S",
        "S.................................................................................DD>.............................................DD.....SSSS......D...........................................................................................S",
        "S............................................................................S....DSS......D........................H......DD.............SD......BD...........................................................................................S",
        "S.......................................................................H..................DD...............HH.....DDD....................D......DDD...........................................................................................S",
        "S......................................................................DDD.................SDDH......H.....DDDD.....D.............................DD...........................................................................................S",
        "S.......................................................................D..................SSDDD...DDDDD....DSD...................................<D...........................................................................................S",
        "S.......................................................................D...........................DDD.....DD...................................HDD...................H.............H.........................................................S",
        "S.......................................................................DB...........................DS......D...................................DDD..................DDD...........DDD..DD....................................................S",
        "S.......................................................................DDDD.........................D...........................................DD...................DLD................DD....................................................S",
        "S......................................................................DD.........................................................................D...................DLD...............DDD....................................................S",
        "S.....................................................................HDD.........................................................................DB..................DSDBDD............DSD....................................................S",
        "S.....................................................................DSD.........................................................................DD.............H....SSSS.............DDSD....................................................S",
        "S.....................................................................DSDDD..............................................................................H......DDD..................HDSSSD....................................................S",
        "S..................................C...................................SSD.............................................................................DDDDD......S..................DDSSSDH...................................................S",
        "S..................................D...................................DSD............................................................................................................DDSSDD...................................................S",
        "S..................................SLLLLS..............................DD..............................................................................................................DDSDD...................................................S",
        "S.................................SSLLLSS..............................DDD..............................................................................................................DDSDDDDD...............................................S",
        "S...................................SLSS................................DD...............................................................................................................DDDDSSS...............................................S",
        "S...................................SSS.................................D..................................................................................................................DSSDD...............................................S",
        "S.....................................S......................................................................................................................................................S.....SSSSSSSS....................................S",
        "S.................................................................................................................................................................................................SSLLLLLLS....SS..............................S",
        "S.......................................................................H..........................................................................................................................SSLSSSS.....SS..............................S",
        "S.................................................................D....DDD..........................................................................................................................SLLSSS.....SS....................<SSSSSSSSSS",
        "S..........................................................H.H..........V...........................................................................................................................SSLSS......SS..............................S",
        "S................................................B........DDDDD......................................................................................................................................SSSS......SS..............................S",
        "S................................................D.....D...D.D........................................................................................................................................S........SS..........................<SSSS",
        "S................................................D.....D.......................................................................................................................................................SS..............................S",
        "S................................................D.....DD......................................................................................................................................................SS..............................S",
        "S..........D....................................DD.....D.......................................................................................................................................................SS..............................S",
        "S.......H.DDD....H..H............................D.....D>......................................................................................................................................................SS............................<SS",
        "S.......DDDDD...DDDDDD...........................D.....DD......................................................................................................................................................SS..............................S",
        "S.......SSSDDDHDDSSSSSS..........................D.....D.......................................................................................................................................................SS.........................<SSSSS",
        "S.........SDDDDDSS................DH............HD.....D.......................................................................................................................................................SS..............................S",
        "S.........SSDDDSS................DDD...........DDD.....D.......................................................................................................................................................SS..............................S",
        "S..........SSSSS..................V..............D.....D.......................................................................................................................................................SS..............................S",
        "S...........SS.........................................D.......................................................................................................................................................SS..............................S",
        "S..............................................................................................................................................................................................................SS..............................S",
        "S....................................................H.........................................................................................................................................................SS...........................<SSS",
        "S..............................................HHDSDDD.........................................................................................................................................................SS..............................S",
        "S...........................................DDDDDDDSSS.........................................................................................................................................................SS..............................S",
        "S.............................H........H.....SSLDDDSS..........................................................................................................................................................................................S",
        "S............................DDSS....SSDSS....SSDSS.......................................................................................................................................................................................<SSSSS",
        "S>..................D...H....SSS.....DDDD......SLS.............................................................................................................................................................................................S",
        "S...............H...DDDDDDD...S.......DD.......SSS.............................................................................................................................................................HHH.....B.......................S",
        "S.............DDDSD..SSSSS.............D........SS............................................................................................................................................................DDDDDDDDDDBH.....................S",
        "SH.....H.......SSS....SSS........................S................................................................................................................................................................SDDDDSDDDD..................SS",
        "SSSDDDDDDSD.....S......S..........................................................................................................................................................................................SSDDSS>.....................SS",
        "SSSSSDDSSS.........................................................................................................................................................................................................SSS.......S................SS",
        "S..SSSDS...........................................................................................................................................................................................................SS........S.................S",
        "S....S.............................................................................................................................................................................................................S......S..S..S..............S",
        "S.....................................................................................DDDDD................................................................................................................................S...S...............S",
        "S...........................................................................................................................................................................................................................SSS................S",
        "S............................................................................................................................................................................................................................S.................S",
        "S..............................................................................................................................................................................................................................................S",
        "S..............................................................................................................................................................................................................................................S",
        "S..............................................................................................................................................................................................................................................S",
        "S..............................................................................................................................................................................................................................................S",
        "S............................................................................................................................................................................................................................................EHS",
        "S.........................................................................................................................................................................................................................................DDDDDS",
        "S..............................................................................................................................................................................................................................................S",
        "S..............................................................................................................................................................................................................................................S",
        "S..............................................................................................................................................................................................................................................S",
        "S..............................................................................................................................................................................................................................................S",
        "S..............................................................................................................................................................................................................................................S",
        "S..............................................................................................................................................................................................................................................S",
        "S..............................................................................................................................................................................................................................................S",
        "BBBBBBBBBBBBBBBBBBBBBBBBBBBBBBBBBBBBBBBBBBBBBBBBBBBBBBBBBBBBBBBBBBBBBBBBBBBBBBBBBBBBBBBBBBBBBBBBBBBBBBBBBBBBBBBBBBBBBBBBBBBBBBBBBBBBBBBBBBBBBBBBBBBBBBBBBBBBBBBBBBBBBBBBBBBBBBBBBBBBBBBBBBBBBBBBBBBBBBBBBBBBBBBBBBBBBBBBBBBBBBBBBBBBBBBBBBBBBBBB"
    ],
    "objects": [
        {
            "type": "AK47",
            "pos": [
                88,
                82
            ]
        },
        {
            "type": "Spawn",
            "pos": [
                3,
                78
            ]
        }
    ],
    "version": 2
}