{
    "size": [
        120,
        40
    ],
    "blocks": [
        ".SSSSSSSSSSSSSSSSSSSSSSSSSSSSSSSSSSSSSSSSSSSSSSSSSSSSSSSSSSSSSSSSSSSSSSSSSSSSSSSSSSSSSSSSSSSSSSSSSSSSSSSSSSSSSSSSSSSSSS.",
        "SD...............V.....VDDV............................................................................................S",
        "SD......................DD.............................................................................................S",
        "SD......................DD.............................................................................................S",
        "SD......................DD.............................................................................................S",
        "SD......................DD.............................................................................................S",
        "SD......................DD.............................................................................................S",
        "SD......................DD.............................................................................................S",
        "SD......................DD.............................................................................................S",
        "SD......................DD.............................................................................................S",
        "SD......................DD...............B.D...........................................................................S",
        "SD......................DDD..............DDD...........................................................................S",
        "SD......................DDD.............DDDD...........................................................................S",
        "SD......................DDD...........DDDDDD...........................................................................S",
        "SD......................DD..........DDDDDDDD...........................................................................S",
        "SD........DD............DD..........DDDDDDDD...........................................................................S",
        "SD........DD............DD...............VDD...........................................................................S",
        "SD........DD............DD................DD...........................................................................S",
        "SD........DD............DD................DD...........................................................................S",
        "SD........DD............DD................DD...........................................................................S",
        "SD........DD............DD................DD...........................................................................S",
        "SD........DD............DD................DD...........................................................................S",
        "SD........DD............DDDDD............DDD...........................................................................S",
        "SD........DD............DDV.............DDDD...........................................................................S",
        "SD........DD............DD.............DDDDD...........................................................................S",
        "SD........DD............DD..............DDDD...........................................................................S",
        "SD........DD............DD..............DDDD...........................................................................S",
        "SD........DD............................DDDD...........................................................................S",
        "SD........DD.............................DDD^..........................................................................S",
        "SD........DD..............................DDD..........................................................................S",
        "SD........DD..............................DDDD.......................................................................E.S",
        "SD........DD..............................DDDDD....................DDDDDDDDD......................................DDDDDS",
        "SDD......^DD.....................B........DDDDDD>...........<DDDDDDDDDDDDDDDDDDDD................................DDDDDDS",
        "SDDDDDDDDDDDDDDDDDDDDDDDDDDDDDDDDDDDDDDDDDDDDDDDDDDDDDDDDDDDDDDDDDDDDDDDDDDDDDDDDDD..........DD...............DDDDDDDDDS",
        "SDDDDDDDDDDDDDDDDDDDDDDDDDDDDDDDDDDDDDDDDDDDDDDDDDDDDDDDDDDDDDDDDDDDDDDDDDDDDDDDDDDDDSSSSSDDDDDDDDDDDDDDDDDDDDDDDDDDDDDS",
        "SDDDDDDDDDDDDDDDDDDDDDDDDDDDDDDDDDDDDDDDSSDDDDDDDDDDDDDDDSDDDDDDDDDDDDDDDSSDDDDDDDDDSSSSSSSSDDDDDDDDDDDDDSSDDDDDDDDDDDSS",
        "SSDDDSSDDSDSSSSDDDDDSSSDDSSSSSDDDDDDDDSSSSSSSDDSDDDDDDSSSSSDDDDSSSSSDDDDSSSDDDDDDDDSSSSSSSSSSSSSSDDDDDDDSSSSSSDDDDSSSSSS",
        "SSDDSSSSSSSSSSSSDDDSSSSSDSSSSSSDSSSSDSSSSSSSSSSSSDDSDDSSSSSSDSSSSSSSSSSSSSSSSSDDSSSSSSSSSSSSSSSSSSDDSSDSSSSSSSSSDSSSSSSS",
        "SSSSSSSSSSSSSSSSSSSSSSSSSSSSSSSSSSSSSSSSSSSSSSSSSSSSSSSSSSSSSSSSSSSSSSSSSSSSSSSSSSSSSSSSSSSSSSSSSSSSSSSSSSSSSSSSSSSSSSSS",
        ".BBBBBBBBBBBBBBBBBBBBBBBBBBBBBBBBBBBBBBBBBBBBBBBBBBBBBBBBBBBBBBBBBBBBBBBBBBBBBBBBBBBBBBBBBBBBBBBBBBBBBBBBBBBBBBBBBBBBBB."
    ],
    "objects": [
        {
            "type": "Spawn",
            "pos": [
                37,
                11
            ]
        }
    ],
    "version": 2
}