{
    "size": [
        120,
        40
    ],
    "blocks": [
        "SSSSSSSSSSSSSSSSSSSSSSSSSSSSSSSSSSSSSSSSSSSSSSSSSSSSSSSSSSSSSSSSSSSSSSSSSSSSSSSSSSSSSSSSSSSSSSSSSSSSSSSSSSSSSSSSSSSSSSSS",
        "S......................................................................................................................S",
        "S......................................................................................................................S",
        "S......................................................................................................................S",
        "S......................................................................................................................S",
        "S......................................................................................................................S",
        "S......................................................................................................................S",
        "S....................................................C.................................................................S",
        "S.........F...................DDD......................................................................................S",
        "S........F.....................<D......................................................................................S",
        "S......FF...................D...V......................................................................................S",
        "S...........................D..........................................................................................S",
        "S......................................................................................................................S",
        "S......................................................................................................................S",
        "S................................................................................F.....................................S",
        "S.....................................................F...........................F....................................S",
        "S.......................D............................F.............................F....................F..............S",
        "S.......................D...........................................F.F............F....................F..............S",
        "S....................................................................................F...................F.............S",
        "S....................D............F.......................................................................F............S",
        "S....................D...........FF....................................................................................S",
        "S................................F.....................................................................................S",
        "S...............................F......................................................................................S",
        "S...............................F......................................................................................S",
        "S......................................................................................................................S",
        "S......................................................................................................................S",
        "S...............DD>....................................................................................................S",
        "S......................................................................................................................S",
        "S......................................................................................................................S",
        "S.....................................................................................................................HS",
        "S.....................................................................................................DDH............HDS",
        "SDDD.............................................B.......H...................DDDD...............<DDDLDDDDD.........EHDDS",
        "SDSDDH............H....................H.DDDDDDDDDDSSDDDDDDDDDD.......^.....DDDDDD............DD.DDDDDDDDD.B...B.DDDDDDS",
        "SDSSDDDH......SSDDDDD..............<DDDDDDDSDDSDDDSSSSSDDDDDDSDDDDH.DDDDDDLLDDSDDDDD^DDDDDDDLDDDDDDDDDSSDDDDLLLDDDSDDDDS",
        "SSSSSSDDDDDDDSSSSDDDDDSSSDDDDDDLLLLDDSDDDSSSSSSDDDSSSSSDDDDSSSDDDDDDDSDDDDDDDDSSDDDDDDDDDDDDDDDDDDDDSSSSSSDDLLDDDDSDDDDS",
        "SSSSSDDDSSDDDDSSDDDDDDSSSSDSSSSSLLSSSSDDDSSDDSSSDDDSSSDDDDDSSSSSSSSDSSDSSDDSSSSSSSDDDDSDSDDDDDDDDSSSSSSSSSDDLLLDDDSSDSDS",
        "SSSSSDDSSDDDDSSSSSDDSDDSSSSSSSSLLLLLDSDDDDDDDSSSDDSSSSDSSSSSSSSSSSSSSSSSSSSSSSSSSSSSSDSSSSDDDDSSSSSSSSSSSSSLLLLSDSSSSSSS",
        "SSSSSSSSSDSSSSSSSSSSSDDSSSSSSSLLLLLLLDDDDDDDDDDSSSSSSSSSSSSSSSSSSSSSSSSSSSSSSSSSSSSSSSSSSSSSDSSSSSSSSSSLLLLLLLLLLLLSSSSS",
        "SSSSSSSSSSSSSSSSSSSSSSSSSSSSSLLLLLLLLLLLSSSSSSSSSSSSSSSSSSSSSSSSSSSSSSSSSSSSSSSSSSSSSSSSSSSSSSSSSSSSSSLLLLLLLLLLLLLSSSSS",
        "BBBBBBBBBBBBBBBBBBBBBBBBBBBBBBBBBBBBBBBBBBBBBBBBBBBBBBBBBBBBBBBBBBBBBBBBBBBBBBBBBBBBBBBBBBBBBBBBBBBBBBBBBBBBBBBBBBBBBBBB"
    ],
    "objects": [
        {
            "type": "AK47",
            "pos": [
                31,
                7
            ]
        },
        {
            "type": "Spawn",
            "pos": [
                2,
                29
            ]
        }
    ],
    "version": 2
}