{
    "size": [
        71,
        40
    ],
    "blocks": [
        "SSSSSSSSSSSSSSSSSSSSSSSSSSSSSSSSSSSSSSSSSSSSSSSSSSSSSSSSSSSSSSSSSSSSSSS",
        "S.......D.............................................................S",
        "S.....................................................................S",
        "S.....................................................................S",
        "S.....................................................................S",
        "S.....................................................................S",
        "S.....................................................................S",
        "S.....................................................................S",
        "S.....................................................................S",
        "S.....................................................................S",
        "S.....................................................................S",
        "S.....................................................................S",
        "S.....................................................................S",
        "S.....................................................................S",
        "S.....................................................................S",
        "S.....................................................................S",
        "S.....................................................................S",
        "S.....................................................S...............S",
        "S.....................................................S...............S",
        "S.....................................................S...............S",
        "S.....................................................S...............S",
        "S.....................................................S...............S",
        "S.....................................................S...............S",
        "S.....................................................S...............S",
        "S.....................................................S...............S",
        "S.....................................................S...............S",
        "S.....................................................S...............S",
        "S.....................................................S...............S",
        "S.....................................................S...............S",
        "S...................................D................DSD..............S",
        "S.................................DDDDD.............DDSDD.............S",
        "S...............................DDDDDDDDDDDD.......DDDSDDD............S",
        "S........................DDDDDDDDDDDDDDDDDDDDDDDDLDDDDSDDDD.........E.S",
        "SDDDDSDDDDDDDDDDDDDDDDDDDDDDDDDDDDDDDDDDDDDDDDDDDDDDDDSDDDDDDDDDDDDDDDS",
        "SDDDSSSDDDDDDDDDDDDDDDDDDDDDDDDDDDDDDDDDDDDDDDDDDDDDDDSDDDDDDDDDDDDDDDS",
        "SDDSSSSSDDDDDDDDDDDDDDDDDDDDDDDDDDDDDDDDDDDDDDDDDDDDDDSDDDDDDDDDDDDDDDS",
        "SSSSSSSSSSSSSSSSSDDDDSSSSSDDSSSSSSSSSSDDDDDDDDDSSSSSSSSSSSSSSSSDDDDDDDS",
        "SSSSSSSSSSSSSSSSSSDSSSSSSSSDSSSSSSSSSSDDDDDDSSSSSSSSSSSSSSSSSSSSSDDDDDS",
        "SSSSSSSSSSSSSSSSSSSSSSSSSSSSSSSSSSSSSSSSSSSSSSSSSSSSSSSSSSSSSSSSSSSSDDS",
        "BBBBBBBBBBBBBBBBBBBBBBBBBBBBBBBBBBBBBBBBBBBBBBBBBBBBBBBBBBBBBBBBBBBBBBB"
    ],
    "objects": [
        {
            "type": "Spawn",
            "pos": [
                5,
                31
            ]
        },
        {
            "type": "AK47",
            "pos": [
                54,
                16
            ]
        }
    ],
    "version": 2
}