{
    "size": [
        120,
        40
    ],
    "blocks": [
        "SSSSSSSSSSSSSSSSSSSSSSSSSSSSSSSSSSSSSSSSSSSSSSSSSSSSSSSSSSSSSSSSSSSSSSSSSSSSSSSSSSSSSSSSSSSSSSSSSSSSSSSSSSSSSSSSSSSSSSSS",
        "SD...............V.....VDDV.........................................DDV................................................S",
        "SD......................DD..........................................DD.................................................S",
        "SD......................DD.............................................................................................S",
        "SD......................DD...............................C.............................................................S",
        "SD......................DD.............................................................................................S",
        "SD......................DD..........................................DD...................................DD............S",
        "SD......................DD...........................................D...................................DD............S",
        "SD......................DD...........................................D..........................^..H.....DD............S",
        "SD......................DD..........................................DD^HDD^SS^SS>...H..<DD>....<DDDD.....DD............S",
        "SD......................DD...............B.D........................DDDDDSSSSSSSDDDDDDDDDVDDDDDDDDSD.....DD............S",
        "SD......................DDD..............DDD.........................DD...........................DS.....DD............S",
        "SD......................DSS.............DDDD.........................DD............................D.....DD............S",
        "SD...H..................DSD..........HDDDDDD.........................D...................................DD............S",
        "SD......................DD..........DDDDSSSD.........................DD..................................DD............S",
        "SD........DD............DD..........DDDSDDDD..........................D..................................DD............S",
        "SD........DD............DD...............VDD.........................HD..................................DD............S",
        "SD........DD............DD................DD.........................DD......DD.B..DH....................DD............S",
        "SD........DD............DD................DD........................DD.......DDDDDDDDDDDDDDD^DDDDDDDDDD^DSD............S",
        "SD........DD............DD................DD........................DD.......DDDSSS..SSDD..DDD...DD...DDSSD............S",
        "SD........DD............DD................DD........................DD...................................DD............S",
        "SD........DD............DDH...............DD........................DD...................................DD............S",
        "SD........DD............DDDDD...........HDDD........................DDD..................................DD............S",
        "SD........DD............DDV.............DDDD........................DD...................................DD............S",
        "SD........DD............DD.............DDSSD........................SD...................................DD............S",
        "SD........DD............DD..............DSDD........................SS>.........HDDDDD...................DD............S",
        "SD........DD............DD..............DSSD........................DSDDDDDDDDDDDDDDDDDDDDDDDH...........DD............S",
        "SD........DD............................DDDD................................................DDDDDD.......DD............S",
        "SD........DD.............................DDD^...................................................DD.......DD............S",
        "SD........DD..............................DDD............................................................DD............S",
        "SD........DD..............................DDDD...........................................................DD..........EHS",
        "SD........DD..............................DDDDDH...............H.........................................DD.......DDDDDS",
        "SDDH.....^DD....HHHH.............B........DDDDDD>...........<DDDDD>...H....H.............................DD.....HDDDDDDS",
        "SSDDDDDDDDSDDDDDDDDDDDDDDDDDDDDDDDDDDDDDDDDDDSDDDDDDDDDDDDDDDDDDDDDDDDDDDDDDDDDDDDD>.................H...DS^..DDDDDDDDDS",
        "SDDDDDDDDDSSDSDDDDDDDSDDDDDDDDDDDDDDDDDDDDDDSSDDDDDDDDDDDDDDDDDSDDDDDDDDDDDDDDDDDDDDDSSSSSDDDDDDDDDDDDDDDDSSDDDDDDDDDDDS",
        "SLDDDSDSSLLSSSSDDDDDDSDDDDSSDDDDDDDDDDDDSSDDSSDDDDDDDDDDDSDDDDDSSDDDDDDDDSSDDDDDDDDDSSSLSSSSDDDDDDDDDDDDDSSDDDDDDDDSDDSS",
        "SLLDDSSSSLLLLSSDDDDDSSSDDSSSSSDDDDDDDDSSSSSSSDDSDDDDDDSSSSSDDDDLLSSSDDDDSSSDDDDDDDDSSSLLLSSSSSSSSDDDDDDDSSLSSSDDDDSSSLSS",
        "SLSDSLLLLLLLLLSSDDDSSSSSDSSSSSSDSSSSDSSSSSSSSSSSSDDSDDSSSSSSDSLLLLLLSSSSSSSSSSDDSSSSSLLLLLSSSSSSSSDDSSDSSLLLLSSSDSSSLLLS",
        "SLSSSLLSSLLLLSSSSSSSSSSSSSSSSSSSSSSSSSSSSSSSSSSSSSSSSSSSSSSSSLLLLLLSSSSSSSSSSSSSSSSSSSLLLLLSSSSSSSSSSSSSLLLLSSSSSSLLLLLS",
        "BBBBBBBBBBBBBBBBBBBBBBBBBBBBBBBBBBBBBBBBBBBBBBBBBBBBBBBBBBBBBBBBBBBBBBBBBBBBBBBBBBBBBBBBBBBBBBBBBBBBBBBBBBBBBBBBBBBBBBBB"
    ],
    "objects": [
        {
            "type": "Spawn",
            "pos": [
                3,
                29
            ]
        },
        {
            "type": "AK47",
            "pos": [
                79,
                8
            ]
        }
    ],
    "version": 2
}