{
    "size": [
        120,
        40
    ],
    "blocks": [
        "SSSSSSSSSSSSSSSSSSSSSSSSSSSSSSSSSSSSSSSSSSSSSSSSSSSSSSSSSSSSSSSSSSSSSSSSSSSSSSSSSSSSSSSSSSSSSSSSSSSSSSSSSSSSSSSSSSSSSSSS",
        "S......................................................................................................................S",
        "S......................................................................................................................S",
        "S......................................................................................................................S",
        "S......................................................................................................................S",
        "S......................................................................................................................S",
        "S......................................................................................................................S",
        "S......................................................................................................................S",
        "S......................................................................................................................S",
        "S......................................................................................................................S",
        "S......................................................................................................................S",
        "S......................................................................................................................S",
        "S......................................................................................................................S",
        "S......................................................................................................................S",
        "S......................................................................................................................S",
        "S......................................................................................................................S",
        "S......................................................................................................................S",
        "S......................................................................................................................S",
        "S......................................................................................................................S",
        "S......................................................................................................................S",
        "S......................................................................................................................S",
        "S...............................................................................C......................................S",
        "S......................................................................................................................S",
        "S......................................................................................................................S",
        "S......................................................................................................................S",
        "S........................................................BD.D..........................................................S",
        "S........................................................SSSSS........................................................<S",
        "S........................................................S.V.S.........................................................S",
        "S......................................................................................................................S",
        "S...................................................DDD................................................................S",
        "S......................................................................................................................S",
        "S......................................................................................................................S",
        "S......................................................................................................................S",
        "S....................................................................................................................E.S",
        "SDDDDDDDDDD..B..DDDDDDDDDDDDD...........DDDDD...DDDDDDDDDDDDDDDDDDDDDD^DDDDDDDD>...............DDDDDDDLLLDDDDDDDDDDDDDDS",
        "SDDDDDDDDDDDDDDDDDDDDDDDDDDDDD..........DDDDDD^DDDDDDDDDDDDDDDDDDDDDDDDDDDDDDDDDDDDDDDDDDDDDDDDDDDDDDDDLDDDDDDDDDDDDDDDS",
        "SDDDDDDDDDDDDDDDDDDDDDDDDDDDDDD........DDDDDDDDDDDDDDDDDDDDDDDDDDDDDDDDDDDDDDDDDDDDDDDDDDDDDDDDDDDDDDDLLLDDDDDDDDDDDDDDS",
        "SSSSSSSSSSSSSSSSSSSSSSSSSSSSSSSL......LSSSSSSSSSSSSSSSSSSSSSSSSSSSSSSSSSSSSSSSSSSSSSSSSSSSSSSSSSSSSSLLLLLLLSSSSSSSSSSSSS",
        "SSSSSSSSSSSSSSSSSSSSSSSSSSSSSSSLL....LLSSSSSSSSSSSSSSSSSSSSSSSSSSSSSSSSSSSSSSSSSSSSSSSSSSSSSSSSSSSLLLLLLLLLLLSSSSSSSSSSS",
        "BBBBBBBBBBBBBBBBBBBBBBBBBBBBBBBBBBBBBBBBBBBBBBBBBBBBBBBBBBBBBBBBBBBBBBBBBBBBBBBBBBBBBBBBBBBBBBBBBBBBBBBBBBBBBBBBBBBBBBBB"
    ],
    "objects": [
        {
            "type": "Spawn",
            "pos": [
                2,
                32
            ]
        },
        {
            "type": "AK47",
            "pos": [
                59,
                24
            ]
        }
    ],
    "version": 2
}