40 71
SSSSSSSSSSSSSSSSSSSSSSSSSSSSSSSSSSSSSSSSSSSSSSSSSSSSSSSSSSSSSSSSSSSSSSS
S.....................................................................S
S.....................................................................S
S.....................................................................S
S.....................................................................S
S.....................................................................S
S.....................................................................S
S.....................................................................S
S.....................................................................S
S.....................................................................S
S.....................................................................S
S.....................................................................S
S.....................................................................S
S.....................................................................S
S.....................................................................S
S.....................................................................S
S.....................................................D...............S
S.....................................................S...............S
S.....................................................S...............S
S.....................................................S...............S
S.....................................................S...............S
S.....................................................S...............S
S.....................................................S...............S
S.....................................................S...............S
S.....................................................S...............S
S.....................................................S...............S
S.....................................................S...............S
S.....................................................S...............S
S.....................................................S...............S
S....................................................DSD..............S
S.................................DDDDD.............DDSDD.............S
S.P.............................DDDDDDDDDDDD.......DDDSDDD............S
S........................DDDDDDDDDDDDDDDDDDDDDDDD.DDDDSDDDD.........E.S
SDDDDSDDDDDDDDDDDDDDDDDDDDDDDDDDDDDDDDDDDDDDDDDDDDDDDDSDDDDDDDDDDDDDDDS
SDDDSSSDDDDDDDDDDDDDDDDDDDDDDDDDDDDDDDDDDDDDDDDDDDDDDDSDDDDDDDDDDDDDDDS
SDDSSSSSDDDDDDDDDDDDDDDDDDDDDDDDDDDDDDDDDDDDDDDDDDDDDDSDDDDDDDDDDDDDDDS
SSSSSSSSSSSSSSSSSDDDDSSSSSDDSSSSSSSSSSDDDDDDDDDSSSSSSSSSSSSSSSSDDDDDDDS
SSSSSSSSSSSSSSSSSSDSSSSSSSSDSSSSSSSSSSDDDDDDSSSSSSSSSSSSSSSSSSSSSDDDDDS
SSSSSSSSSSSSSSSSSSSSSSSSSSSSSSSSSSSSSSSSSSSSSSSSSSSSSSSSSSSSSSSSSSSSDDS
BBBBBBBBBBBBBBBBBBBBBBBBBBBBBBBBBBBBBBBBBBBBBBBBBBBBBBBBBBBBBBBBBBBBBBB