{
    "size": [
        120,
        40
    ],
    "blocks": [
        "SSSSSSSSSSSSSSSSSSSSSSSSSSSSSSSSSSSSSSSSSSSSSSSSSSSSSSSSSSSSSSSSSSSSSSSSSSSSSSSSSSSSSSSSSSSSSSSSSSSSSSSSSSSSSSSSSSSSSSSS",
        "S......................................................................................................................S",
        "S......................................................................................................................S",
        "S......................................................................................................................S",
        "S......................................................................................................................S",
        "S......................................................................................................................S",
        "S......................................................................................................................S",
        "S......................................................................................................................S",
        "S......................................................................................................................S",
        "S......................................................................................................................S",
        "S......................................................................................................................S",
        "S......................................................................................................................S",
        "S......................................................................................................................S",
        "S......................................................................................................................S",
        "S......................................................................................................................S",
        "S......................................................................................................................S",
        "S......................................................................................................................S",
        "S......................................................................................................................S",
        "S......................................................................................................................S",
        "S......................................................................................................................S",
        "S......................................................................................................................S",
        "S......................................................................................................................S",
        "S......................................................................................................................S",
        "S......................................................................................................................S",
        "S......................................................................................................................S",
        "S......................................................................................................................S",
        "S......................................................................................................................S",
        "S......................................................................................................................S",
        "S......................................................................................................................S",
        "S......................................................................................................................S",
        "S......................................................................................................................S",
        "SDD....B..................................................................................D............................S",
        "SDDDDDDDDDDD>.........DDD^...........D..D...............................D>........D......DD.........DD.B...D.........E.S",
        "SDDDDDDDDDSDLDDDDD.B..DDDDDDDDD.....<D..DD>........DDDD^DDD^DDD..DDDD...DDDDD....DDDDD.B.DD>........DDDDLLDDD....D..DDDS",
        "SSSDDSSDDDSDLDDDDDDDDDDSSDDDDSDDDDDDDD^DDDDDDDDDLLDDDDDDDDDDDDDD^DDDDD^DDSSDDDDDDDDDDDDDDDDD...DLDDDDDDDDDDDDD^DDDDDDDDS",
        "SSSSSSSSSSSSLLLDDSDDDSSSDDDDSSDDDDDSDDDDDDDDSSDDDDDDDDSDDDDDDSSDDDDSSDDDDSSSDDDDDDDDDDDSSDDDDDDDDDDDDDDSSDDDSDDDDDDDDDDS",
        "SSSSSSSSSSLLLLLLSSDDSSSDDDSSSSSSDSSSSSSDSSDDSSSDSSSSSDSSSSSSSSSSSSSSSSDDSSSSSSDDDDDDSSSSSSSSDDDDDDSSSSSSSDDDSSSDDDDDSSSS",
        "SSSSLLLLLLLLLLLLLSSSSSSSSSSSSSSSSSSSSSSSSSSSSSSSSSSSSSSSSSSSSSSSSSSSSSSSSSSSSSSSSSSSSSSSSSSSSSSSSSSSSSSSSSSSSSSSSSSSSSSS",
        "SSSLLLSSLLLLLLLLSSSSSSSSSSSSSSSSSSSSSSSSSSSSSSSSSSSSSSSSSSSSSSSSSSSSSSSSSSSSSSSSSSSSSSSSSSSSSSSSSSSSSSSSSSSSSSSSSSSSSSSS",
        "BBBBBBBBBBBBBBBBBBBBBBBBBBBBBBBBBBBBBBBBBBBBBBBBBBBBBBBBBBBBBBBBBBBBBBBBBBBBBBBBBBBBBBBBBBBBBBBBBBBBBBBBBBBBBBBBBBBBBBBB"
    ],
    "objects": [
        {
            "type": "Spawn",
            "pos": [
                2,
                29
            ]
        },
        {
            "type": "AK47",
            "pos": [
                46,
                33
            ]
        }
    ],
    "version": 2
}