{
    "size": [
        240,
        100
    ],
    "blocks": [
        "SSSSSSSSSSSSSSSSSSSSSSSSSSSSSSSSSSSSSSSSSSSSSSSSSSSSSSSSSSSSSSSSSSSSSSSSSSSSSSSSSSSSSSSSSSSSSSSSSSSSSSSSSSSSSSSSSSSSSSSSSSSSSSSSSSSSSSSSSSSSSSSSSSSSSSSSSSSSSSSSSSSSSSSSSSSSSSSSSSSSSSSSSSSSSSSSSSSSSSSSSSSSSSSSSSSSSSSSSSSSSSSSSSSSSSSSSSSSSSSS",
        "S..............................................................................................................................................................................................................................................S",
        "S..............................................................................................................................................................................................................................................S",
        "S..............................................................................................................................................................................................................................................S",
        "S..............................................................................................................................................................................................................................................S",
        "S..............................................................................................................................................................................................................................................S",
        "S..............................................................................................................................................................................................................................................S",
        "S..............................................................................................................................................................................................................................................S",
        "S..............................................................................................................................................................................................................................................S",
        "S..............................................................................................................................................................................................................................................S",
        "S..............................................................................................................................................................................................................................................S",
        "S..............................................................................................................................................................................................................................................S",
        "S..............................................................................................................................................................................................................................................S",
        "S..............................................................................................................................................................................................................................................S",
        "S..............................................................................................................................................................................................................................................S",
        "S..............................................................................................................................................................................................................................................S",
        "S..............................................................................................................................................................................................................................................S",
        "S..............................................................................................................................................................................................................................................S",
        "S..............................................................................................................................................................................................................................................S",
        "S..............................................................................................................................................................................................................................................S",
        "S..............................................................................................................................................................................................................................................S",
        "S..............................................................................................................................................................................................................................................S",
        "S..............................................................................................................................................................................................................................................S",
        "S..............................................................................................................................................................................................................................................S",
        "S..............................................................................................................................................................................................................................................S",
        "S..............................................................................................................................................................................................................................................S",
        "S..............................................................................................................................................................................................................................................S",
        "S..............................................................................................................................................................................................................................................S",
        "S..............................................................................................................................................................................................................................................S",
        "S..............................................................................................................................................................................................................................................S",
        "S..............................................................................................................................................................................................................................................S",
        "S..............................................................................................................................................................................................................................................S",
        "S........................................................................................................................................H.B...................................................................................................S",
        "S.................................................................................HDDD...........................................DHDDD..DDDDDD..DDD............................................................................................S",
        "S.................................................................................DD>.............................................DD...............D...........................................................................................S",
        "S............................................................................S....DSS......D........................H......DD.....................BD...........................................................................................S",
        "S.......................................................................H..................DD...............HH.....DDD...........................DDD...........................................................................................S",
        "S.........................................C............................DDD.................SDDH......H.....DDDD...................................DD...........................................................................................S",
        "S.......................................................................D..................SSDDD...DDDDD..........................................<D...........................................................................................S",
        "S.......................................................................D........................................................................HDD...................H.............H.........................................................S",
        "S.......................................................................DB.......................................................................DDD..................DDD...........DDD..DD....................................................S",
        "S.......................................................................DDDD.....................................................................DD...................DDD................DD....................................................S",
        "S......................................................................DD.........................................................................D...................DDD................DD....................................................S",
        "S.....................................................................HDD.........................................................................DB..................DSDBDD.............DD....................................................S",
        "S.....................................................................DDD.........................................................................DD.............H....SSSS...............DD....................................................S",
        "S.....................................................................DDDDD..............................................................................H......DDD......................DD....................................................S",
        "S......................................................................DDD.............................................................................DDDDD......S......................DD....................................................S",
        "S......................................................................DDD...............................................................................................................DD....................................................S",
        "S......................................................................DD................................................................................................................DD....................................................S",
        "S......................................................................DDD...............................................................................................................DDSSSSS...............................................S",
        "S.......................................................................DD...............................................................................................................DDSSSSS...............................................S",
        "S.......................................................................D..................................................................................................................SSSSS...............................................S",
        "S..................................................................................................................................................................................................SSSSSSSS....................................S",
        "S..................................................................................................................................................................................................SSSSSSSS....SS..............................S",
        "S.......................................................................H......................................................................................................................................SS..............................S",
        "S.................................................................D....DDD.....................................................................................................................................SS....................<SSSSSSSSSS",
        "S..........................................................H.H..........V......................................................................................................................................SS..............................S",
        "S................................................B........DDDDD................................................................................................................................................SS..............................S",
        "S................................................D.....D...D.D.................................................................................................................................................SS..........................<SSSS",
        "S................................................D.....D.......................................................................................................................................................SS..............................S",
        "S................................................D.....DD......................................................................................................................................................SS..............................S",
        "S...............................................DD.....D.......................................................................................................................................................SS..............................S",
        "S................................................D.....D>......................................................................................................................................................SS............................<SS",
        "S................................................D.....DD......................................................................................................................................................SS..............................S",
        "S................................................D.....D.......................................................................................................................................................SS.........................<SSSSS",
        "S.................................DH............HD.....D.......................................................................................................................................................SS..............................S",
        "S................................DDD...........DDD.....D.......................................................................................................................................................SS..............................S",
        "S.................................V..............D.....D.......................................................................................................................................................SS..............................S",
        "S......................................................D.......................................................................................................................................................SS..............................S",
        "S..............................................................................................................................................................................................................SS..............................S",
        "S....................................................H.........................................................................................................................................................SS...........................<SSS",
        "S..............................................HHDDDDD.........................................................................................................................................................SS..............................S",
        "S...........................................DDDDDDDDDD.........................................................................................................................................................SS..............................S",
        "S.............................H........H.......................................................................................................................................................................................................S",
        "S............................DDD.....DDDDD................................................................................................................................................................................................<SSSSS",
        "S>......................H......................................................................................................................................................................................................................S",
        "S...............H.....DDDDD....................................................................................................................................................................................HHH.....B.......................S",
        "S.............DDDDD...........................................................................................................................................................................................DDDDDDDDDDBH.....................S",
        "SH.....H..........................................................................................................................................................................................................DDDDDDDDDD..................SS",
        "SDDDDDDDDDD.......................................................................................................................................................................................................DDDDDD>.....................SS",
        "S............................................................................................................................................................................................................................S................SS",
        "S............................................................................................................................................................................................................................S.................S",
        "S.........................................................................................................................................................................................................................S..S..S..............S",
        "S.....................................................................................DDDDD................................................................................................................................S...S...............S",
        "S...........................................................................................................................................................................................................................SSS................S",
        "S............................................................................................................................................................................................................................S.................S",
        "S..............................................................................................................................................................................................................................................S",
        "S..............................................................................................................................................................................................................................................S",
        "S..............................................................................................................................................................................................................................................S",
        "S..............................................................................................................................................................................................................................................S",
        "S............................................................................................................................................................................................................................................EHS",
        "S.........................................................................................................................................................................................................................................DDDDDS",
        "S..............................................................................................................................................................................................................................................S",
        "S..............................................................................................................................................................................................................................................S",
        "S..............................................................................................................................................................................................................................................S",
        "S..............................................................................................................................................................................................................................................S",
        "S..............................................................................................................................................................................................................................................S",
        "S..............................................................................................................................................................................................................................................S",
        "S..............................................................................................................................................................................................................................................S",
        "BBBBBBBBBBBBBBBBBBBBBBBBBBBBBBBBBBBBBBBBBBBBBBBBBBBBBBBBBBBBBBBBBBBBBBBBBBBBBBBBBBBBBBBBBBBBBBBBBBBBBBBBBBBBBBBBBBBBBBBBBBBBBBBBBBBBBBBBBBBBBBBBBBBBBBBBBBBBBBBBBBBBBBBBBBBBBBBBBBBBBBBBBBBBBBBBBBBBBBBBBBBBBBBBBBBBBBBBBBBBBBBBBBBBBBBBBBBBBBBB"
    ],
    "objects": [
        {
            "type": "Spawn",
            "pos": [
                4,
                77
            ]
        },
        {
            "type": "AK47",
            "pos": [
                88,
                82
            ]
        }
    ],
    "version": 2
}