{
    "size": [
        120,
        40
    ],
    "blocks": [
        "SSSSSSSSSSSSSSSSSSSSSSSSSSSSSSSSSSSSSSSSSSSSSSSSSSSSSSSSSSSSSSSSSSSSSSSSSSSSSSSSSSSSSSSSSSSSSSSSSSSSSSSSSSSSSSSSSSSSSSSS",
        "S......................................................................................................................S",
        "S......................................................................................................................S",
        "S......................................................................................................................S",
        "S......................................................................................................................S",
        "S......................................................................................................................S",
        "S......................................................................................................................S",
        "S....................................................C.................................................................S",
        "S.............................DDD......................................................................................S",
        "S..............................<D......................................................................................S",
        "S...........................D...V......................................................................................S",
        "S...........................D..........................................................................................S",
        "S......................................................................................................................S",
        "S......................................................................................................................S",
        "S......................................................................................................................S",
        "S......................................................................................................................S",
        "S.......................D..............................................................................................S",
        "S.......................D..............................................................................................S",
        "S......................................................................................................................S",
        "S....................D.................................................................................................S",
        "S....................D.................................................................................................S",
        "S......................................................................................................................S",
        "S......................................................................................................................S",
        "S......................................................................................................................S",
        "S......................................................................................................................S",
        "S......................................................................................................................S",
        "S...............DD>....................................................................................................S",
        "S......................................................................................................................S",
        "S......................................................................................................................S",
        "S.....................................................................................................................HS",
        "S.....................................................................................................DDH............HDS",
        "SDDD.............................................B.......H...................DDDD...............<DDDLDDDDD.........EHDDS",
        "SDSDDH............H....................H.DDDDDDDDDDSSDDDDDDDDDD.......^.....DDDDDD............DD.DDDDDDDDD.B...B.DDDDDDS",
        "SDSSDDDH......SSDDDDD..............<DDDDDDDSDDSDDDSSSSSDDDDDDSDDDDH.DDDDDDLLDDSDDDDD^DDDDDDDLDDDDDDDDDSSDDDDLLLDDDSDDDDS",
        "SSSSSSDDDDDDDSSSSDDDDDSSSDDDDDDLLLLDDSDDDSSSSSSDDDSSSSSDDDDSSSDDDDDDDSDDDDDDDDSSDDDDDDDDDDDDDDDDDDDDSSSSSSDDLLDDDDSDDDDS",
        "SSSSSDDDSSDDDDSSDDDDDDSSSSDSSSSSLLSSSSDDDSSDDSSSDDDSSSDDDDDSSSSSSSSDSSDSSDDSSSSSSSDDDDSDSDDDDDDDDSSSSSSSSSDDLLLDDDSSDSDS",
        "SSSSSDDSSDDDDSSSSSDDSDDSSSSSSSSLLLLLDSDDDDDDDSSSDDSSSSDSSSSSSSSSSSSSSSSSSSSSSSSSSSSSSDSSSSDDDDSSSSSSSSSSSSSLLLLSDSSSSSSS",
        "SSSSSSSSSDSSSSSSSSSSSDDSSSSSSSLLLLLLLDDDDDDDDDDSSSSSSSSSSSSSSSSSSSSSSSSSSSSSSSSSSSSSSSSSSSSSDSSSSSSSSSSLLLLLLLLLLLLSSSSS",
        "SSSSSSSSSSSSSSSSSSSSSSSSSSSSSLLLLLLLLLLLSSSSSSSSSSSSSSSSSSSSSSSSSSSSSSSSSSSSSSSSSSSSSSSSSSSSSSSSSSSSSSLLLLLLLLLLLLLSSSSS",
        "BBBBBBBBBBBBBBBBBBBBBBBBBBBBBBBBBBBBBBBBBBBBBBBBBBBBBBBBBBBBBBBBBBBBBBBBBBBBBBBBBBBBBBBBBBBBBBBBBBBBBBBBBBBBBBBBBBBBBBBB"
    ],
    "objects": [
        {
            "type": "AK47",
            "pos": [
                31,
                7
            ]
        },
        {
            "type": "Spawn",
            "pos": [
                2,
                29
            ]
        }
    ],
    "version": 2
}