20 50
..................................................
..................................................
...P..............................................
..................................................
...............................S.D.G..............
...............................SSSSS..............
................................S.S...............
..................................................
..................................................
..................................................
GGGGG.............................................
DDDDDG............................................
DDDDDDGGGGGGGGGGGGGGGGGGGGGGGGGGGGGGGGGGGGGGGGGGGG
SDDDDDDDDDDDDDDDDDDDDDDDDDDDDDDDDDDDDDDDDDDDDDDDDD
SSDDDDDDDDDDDDDDDDDDDDDDDDDDDDDDDDDDDDDDDDDDDDDDDD
SSSSSSDDDDDDDDDDDDDDDDDDDDDDDDDDDDDDDDDDDDDDDSSSSS
SSSSSSSSSSSSSDDDDDDDDSSSSSSSDDDDDDDDDDDDDDSSSSSSSS
SSSSSSSSSSSSSSSDDDSSSSSSSSSSSSSSDDDDSSSSSSSSSSSSSS
SSSSSSSSSSSSSSSSDSSSSSSSSSSSSSSSSDDSSSSSSSSSSSSSSS
SSSSSSSSSSSSSSSSSSSSSSSSSSSSSSSSSSSSSSSSSSSSSSSSSS