{
    "size": [
        120,
        40
    ],
    "blocks": [
        ".SSSSSSSSSSSSSSSSSSSSSSSSSSSSSSSSSSSSSSSSSSSSSSSSSSSSSSSSSSSSSSSSSSSSSSSSSSSSSSSSSSSSSSSSSSSSSSSSSSSSSSSSSSSSSSSSSSSSSS.",
        "SD...............V.....VDDV.........................................DDV................................................S",
        "SD......................DD..........................................DD.................................................S",
        "SD......................DD.............................................................................................S",
        "SD......................DD.............................................................................................S",
        "SD......................DD.............................................................................................S",
        "SD......................DD..........................................DD...................................DD............S",
        "SD......................DD...........................................D...................................DD............S",
        "SD......................DD...........................................D..........................^........DD............S",
        "SD......................DD..........................................DD^.DD^SS^SS>......<DD>....<DDDD.....DD............S",
        "SD......................DD...............B.D........................DDDDDSSSSSSSDDDDDDDDDVDDDDDDDDSD.....DD............S",
        "SD......................DDD..............DDD.........................DD...........................DS.....DD............S",
        "SD......................DSS.............DDDD.........................DD............................D.....DD............S",
        "SD......................DSD...........DDDDDD.........................D...................................DD............S",
        "SD......................DD..........DDDDSSSD.........................DD..................................DD............S",
        "SD........DD............DD..........DDDSDDDD..........................D..................................DD............S",
        "SD........DD............DD...............VDD..........................D..................................DD............S",
        "SD........DD............DD................DD.........................DD......DD.B..D.....................DD............S",
        "SD........DD............DD................DD........................DD.......DDDDDDDDDDDDDDD^DDDDDDDDDD^DSD............S",
        "SD........DD............DD................DD........................DD.......DDDSSS..SSDD..DDD...DD...DDSSD............S",
        "SD........DD............DD................DD........................DD...................................DD............S",
        "SD........DD............DD................DD........................DD...................................DD............S",
        "SD........DD............DDDDD............DDD........................DDD..................................DD............S",
        "SD........DD............DDV.............DDDD........................DD...................................DD............S",
        "SD........DD............DD.............DDSSD........................SD...................................DD............S",
        "SD........DD............DD..............DSDD........................SS>..........DDDDD...................DD............S",
        "SD........DD............DD..............DSSD........................DSDDDDDDDDDDDDDDDDDDDDDDD............DD............S",
        "SD........DD............................DDDD................................................DDDDDD.......DD............S",
        "SD........DD.............................DDD^...................................................DD.......DD............S",
        "SD........DD..............................DDD............................................................DD............S",
        "SD........DD..............................DDDD...........................................................DD..........E.S",
        "SD........DD..............................DDDDD..........................................................DD.......DDDDDS",
        "SDD......^DD.....................B........DDDDDD>...........<DDDDD>......................................DD......DDDDDDS",
        "SSDDDDDDDDSDDDDDDDDDDDDDDDDDDDDDDDDDDDDDDDDDDSDDDDDDDDDDDDDDDDDDDDDDDDDDDDDDDDDDDDD>.....................DS^..DDDDDDDDDS",
        "SDDDDDDDDDSSDSDDDDDDDSDDDDDDDDDDDDDDDDDDDDDDSSDDDDDDDDDDDDDDDDDSDDDDDDDDDDDDDDDDDDDDDSSSSSDDDDDDDDDDDDDDDDSSDDDDDDDDDDDS",
        "SSDDDSDSSSSSSSSDDDDDDSDDDDSSDDDDDDDDDDDDSSDDSSDDDDDDDDDDDSDDDDDSSDDDDDDDDSSDDDDDDDDDSSSSSSSSDDDDDDDDDDDDDSSDDDDDDDDSDDSS",
        "SSSDDSSSSSSSSSSDDDDDSSSDDSSSSSDDDDDDDDSSSSSSSDDSDDDDDDSSSSSDDDDSSSSSDDDDSSSDDDDDDDDSSSSSSSSSSSSSSDDDDDDDSSSSSSDDDDSSSSSS",
        "SSDDSSSSSSSSSSSSDDDSSSSSDSSSSSSDSSSSDSSSSSSSSSSSSDDSDDSSSSSSDSSSSSSSSSSSSSSSSSDDSSSSSSSSSSSSSSSSSSDDSSDSSSSSSSSSDSSSSSSS",
        "SSSSSSSSSSSSSSSSSSSSSSSSSSSSSSSSSSSSSSSSSSSSSSSSSSSSSSSSSSSSSSSSSSSSSSSSSSSSSSSSSSSSSSSSSSSSSSSSSSSSSSSSSSSSSSSSSSSSSSSS",
        ".BBBBBBBBBBBBBBBBBBBBBBBBBBBBBBBBBBBBBBBBBBBBBBBBBBBBBBBBBBBBBBBBBBBBBBBBBBBBBBBBBBBBBBBBBBBBBBBBBBBBBBBBBBBBBBBBBBBBBB."
    ],
    "objects": [
        {
            "type": "Spawn",
            "pos": [
                3,
                29
            ]
        },
        {
            "type": "AK47",
            "pos": [
                79,
                8
            ]
        }
    ],
    "version": 2
}