{
    "size": [
        71,
        40
    ],
    "blocks": [
        "SSSSSSSSSSSSSSSSSSSSSSSSSSSSSSSSSSSSSSSSSSSSSSSSSSSSSSSSSSSSSSSSSSSSSSS",
        "S.......D.............................................................S",
        "S.....................................................................S",
        "S.....................................................................S",
        "S.....................................................................S",
        "S.....................................................................S",
        "S.....................................................................S",
        "S.....................................................................S",
        "S.....................................................................S",
        "S.....................................................................S",
        "S.....................................................................S",
        "S.....................................................................S",
        "S.....................................................................S",
        "S.....................................................................S",
        "S......FFF............................................................S",
        "S.....FFFFF...........................................................S",
        "S....FFFFFFF..........................................................S",
        "S....FFFFFF...........................................D...............S",
        "S.....FF.F............................................D...............S",
        "S.....................................................D...............S",
        "S......................C..............................D...............S",
        "S.....................................................D...............S",
        "S.....................................................D...............S",
        "S.....................................................D...............S",
        "S.....................................................D...............S",
        "S.....................................................D...............S",
        "S.....................................................D...............S",
        "S.....................................................D...............S",
        "S.....................................................D...............S",
        "S...................................D................DDD..............S",
        "S.................................DDDDDHH...........DDDDD.............S",
        "S...........................HHH.DDDDDDDDDDDD.......DDDDDDD............S",
        "S......H.H...........HH..DDDDDDDDDSDDSDDDDDDDDDDDLDDDDDDDDDHH.......EHS",
        "SDDDDSDDDDDSSDDDSDDDDDDDDDSDDDDSDDDDDDDDDDDSDDDDLLLDDDDDDDDDDDDDDDDDDDS",
        "SDDDSSSDSDDDSSSSSSSDDDDDDDDDSDDDDDDDDDDSDDDDDDDLLLLDDSSSSDDDDSDDDDDDDSS",
        "SDDSSSSSDDDSSSSDDDDDDDDSDDDDDDDDDSDDSDDDDSDDDDDDDLDDDDSSSSDDSSSDDSSDDDS",
        "SSSSSSSSSSSSSSSSSDDDDSSSSSDDSSDDSSDDSSDDDDDDDDDSLLLLLSSSSSSSSSSDDSDSSDS",
        "SSSSSSSSSSSSSSSSSSDSSSSSSSSDSSSSSSSDSSDDDDDDSLLLLLLSLSSSSSSSSSSSSSDDSDS",
        "SSSSSSSSSSSSSSSSSSSSSSSSSSSSSSSSSSSDDSSSSSSSSSLLLLLLSSSSSSSSSSSSSSSSDDS",
        "BBBBBBBBBBBBBBBBBBBBBBBBBBBBBBBBBBBBBBBBBBBBBBBBBBBBBBBBBBBBBBBBBBBBBBB"
    ],
    "objects": [
        {
            "type": "Spawn",
            "pos": [
                5,
                31
            ]
        },
        {
            "type": "AK47",
            "pos": [
                54,
                16
            ]
        }
    ],
    "version": 2
}