40 120
SSSSSSSSSSSSSSSSSSSSSSSSSSSSSSSSSSSSSSSSSSSSSSSSSSSSSSSSSSSSSSSSSSSSSSSSSSSSSSSSSSSSSSSSSSSSSSSSSSSSSSSSSSSSSSSSSSSSSSSS
S......................................................................................................................S
S......................................................................................................................S
S......................................................................................................................S
S......................................................................................................................S
S......................................................................................................................S
S......................................................................................................................S
S......................................................................................................................S
S......................................................................................................................S
S......................................................................................................................S
S......................................................................................................................S
S......................................................................................................................S
S......................................................................................................................S
S......................................................................................................................S
S......................................................................................................................S
S......................................................................................................................S
S......................................................................................................................S
S......................................................................................................................S
S......................................................................................................................S
S......................................................................................................................S
S......................................................................................................................S
S......................................................................................................................S
S......................................................................................................................S
S......................................................................................................................S
S......................................................................................................................S
S.........................................................D.D..........................................................S
S>.......................................................SSSSS.........................................................S
S........................................................S.V.S.........................................................S
S......................................................................................................................S
S......................................................................................................................S
S......................................................................................................................S
S......................................................................................................................S
S.P....................................................................................................................S
S....................................................................................................................E.S
SDDDDDDDDDD..B..DDDDDDDDDDDDD...........DDDDD...DDDDDDDDDDDDDDDDDDDDDD^DDDDDDDD>...............DDDDDDDDDDDDDDDDDDDDDDDDS
SDDDDDDDDDDDDDDDDDDDDDDDDDDDDD..........DDDDDD^DDDDDDDDDDDDDDDDDDDDDDDDDDDDDDDDDDDDDDDDDDDDDDDDDDDDDDDDDDDDDDDDDDDDDDDDS
SDDDDDDDDDDDDDDDDDDDDDDDDDDDDDD........DDDDDDDDDDDDDDDDDDDDDDDDDDDDDDDDDDDDDDDDDDDDDDDDDDDDDDDDDDDDDDDDDDDDDDDDDDDDDDDDS
SSSSSSSSSSSSSSSSSSSSSSSSSSSSSSSS......SSSSSSSSSSSSSSSSSSSSSSSSSSSSSSSSSSSSSSSSSSSSSSSSSSSSSSSSSSSSSSSSSSSSSSSSSSSSSSSSSS
SSSSSSSSSSSSSSSSSSSSSSSSSSSSSSSSS....SSSSSSSSSSSSSSSSSSSSSSSSSSSSSSSSSSSSSSSSSSSSSSSSSSSSSSSSSSSSSSSSSSSSSSSSSSSSSSSSSSS
BBBBBBBBBBBBBBBBBBBBBBBBBBBBBBBBBBBBBBBBBBBBBBBBBBBBBBBBBBBBBBBBBBBBBBBBBBBBBBBBBBBBBBBBBBBBBBBBBBBBBBBBBBBBBBBBBBBBBBBB