36 86
SSSSSSSSSSSSSSSSSSSSSSSSSSSSSSSSSSSSSSSSSSSSSSSSSSSSSSSSSSSSSSSSSSSSSSSSSSSSSSSSSSSSSS
S....................................................................................S
S....................................................................................S
S....................................................................................S
S....................................................................................S
S....................................................................................S
S....................................................................................S
S....................................................................................S
S....................................................................................S
S....................................................................................S
S....................................................................................S
S....................................................................................S
S....................................................................................S
S....................................................................................S
S....................................................................................S
S....................................................................................S
S....................................................................................S
S....................................................................................S
S....................................................................................S
S.................................P..................................................S
S...............................S.D.D................................................S
S...............................SSSSS................................................S
S................................S.S.................................................S
S..............................................S...........................S.........S
S.............................................SSS..........................S.........S
S............................................SSSSS.........................S.........S
SDDDDD......................................SSSSSSS........................S.........S
SDDDDDD....................................SSSSSSSSS.......................S.........S
SDDDDDDDDDDDDDDDDDDDDDDDDDDDDDDDDDDDDDDDDDDDDDDDDDDDDDDDDDDDDDDDDDDDDDDDDDDDDDDDDDDDDS
SSDDDDDDDDDDDDDDDDDDDDDDDDDDDDDDDDDDDDDDDDDDDDDDDDDSSSSSSSSSSSSSSSSSSSSSSSSSSSSSSSSSSS
SSSDDDDDDDDDDDDDDDDDDDDDDDDDDDDDDDDDDDDDDDDDDDDDDDDSSSSSSSSSSSSSSSSSSSSSSSSSSSSSSSSSSS
SSSSSSSDDDDDDDDDDDDDDDDDDDDDDDDDDDDDDDDDDDDDDDSSSSSSSSSSSSSSSSSSSSSSSSSSSSSSSSSSSSSSSS
SSSSSSSSSSSSSSDDDDDDDDSSSSSSSDDDDDDDDDDDDDDSSSSSSSSSSSSSSSSSSSSSSSSSSSSSSSSSSSSSSSSSSS
SSSSSSSSSSSSSSSSDDDSSSSSSSSSSSSSSDDDDSSSSSSSSSSSSSSSSSSSSSSSSSSSSSSSSSSSSSSSSSSSSSSSSS
SSSSSSSSSSSSSSSSSDSSSSSSSSSSSSSSSSDDSSSSSSSSSSSSSSSSSSSSSSSSSSSSSSSSSSSSSSSSSSSSSSSSSS
SSSSSSSSSSSSSSSSSSSSSSSSSSSSSSSSSSSSSSSSSSSSSSSSSSSSSSSSSSSSSSSSSSSSSSSSSSSSSSSSSSSSSS