{
    "size": [
        120,
        40
    ],
    "blocks": [
        "SSSSSSSSSSSSSSSSSSSSSSSSSSSSSSSSSSSSSSSSSSSSSSSSSSSSSSSSSSSSSSSSSSSSSSSSSSSSSSSSSSSSSSSSSSSSSSSSSSSSSSSSSSSSSSSSSSSSSSSS",
        "S..SSLSSS.......DDDDDDDDDDD..SSLLLSSSS......DDDDDDDDDDDDDDDDDDDDDDDDDDDDDDDDDDDDDDDDDDDDDDDDDDD........SSSSS....DDDDDDDS",
        "S.SSSSSLSSS..DDDDDDDDDSS....SSSSLSSSSSDDDDDDDDDDDDDDDDDDDDDDDDDDDDDDDDDDD......DDDDDDDDDDDDDDDDDD......SSS.......DDDDDDS",
        "S.SLLSSSS..DDDDDDDDDDS.......SSSSSSS..DDDDDDDDDDDSSSSSSDDDDDDDDDDDDDDDDD................DDDDDDDDDDD..SSS............DDDS",
        "S.SLSSSS..DDDDDDDDDSSS....C.SSSSSSS.DDDDDDDDDDDSSS...............DDDDDDDDD.DD...............DDDDDDSSSSS..............DDS",
        "S.SLSSSSSDSSDDDDDDSSS.......S......DDDDDDSSSSSSSS....................DDDDDDDDH................DDSSSSSD......S.........DS",
        "SSSLSSSDSSSSDDDDDS.SSSSS.........HDDDDDSSSSSSS..........HDDD............DDDDDD.................SDDDDD.....SSSS.........S",
        "SLSSSLDDSDDD.DDDSSSSSSSSSSSSS...DDDDSSSSSSS..........HDDDDDDDDDH...........DDDDD...............D.........SSLSS.......SSS",
        "SLSSSLDDDDDDDDD.S..SSS...SSSSSSSSSSSSSSS.S..........DDDDDDDDDDDDDH...........DDD.....DDSSSSD...........SSSLLLSS......SSS",
        "SSSSLLDDSSD...SSS...S.......SSSSSSSSS.............DDDDDDDDD.SSDDDDD.S.........DDD.....DDDDD...........SSSSSSLSS....SSSSS",
        "SS.SSSDDDSD.D..S.............SSS................SSDDDDS.DD......DDDD.S.S.......DDD......D.........SSSSDDD.SSSS....SSSS.S",
        "S.H.DSDDDDD....................................SSDDDDSS...........DDDSSS........DDD............SSS.SDDSDD..SSS....S.S.SS",
        "S.DDDSSDDD.....................................SDDDD..............DDDSSSS.......DDD..................DDDDD...S.ESSSSS.SS",
        "SD.DDDDDDD............SSSS...................SSSDDD.......DD.......DDDSSS...SSSS.DDH.................<DDDDDH..SSSSSSSSSS",
        "S.D.DDDD...............SSSSSS................SSDDD......DDDDDD....SDDDSSS....SSSSDDD..................DDDDDD..SSLLLLSSSS",
        "SDDDDDDD...............SS...SSS............SSSSDD.....HDDDLLDD....DDDDSSS.....SSSDDD..................SDDDDD..SSLLLLLSSS",
        "SDDDDDD.........H............SSSS........SSSSSSDD....DDDDDDDDD....DDDDSS......SSSDDDH..................SDDDD..SLLLLLLSSS",
        "SDDDDD.........DDDSSSDD......DSSS........SSSSSSDD..HDDDD.DDDD.....DDDDSS......SSSDDDD..................SDDSSS.SLLLLLLLSS",
        "SDDDDD...........DDDDD.......DSSSS......SSSS..DD...DDDD.........SDDDDSSS.......SSSDDD.................<SDSSSS.SLLLLLLLSS",
        "SDDDD..............D.........DSSSSS.....S....HDDH..SDDDDH.......DDDDDS.........SSSDDD.................SSSDLSLSSSLLLLLLSS",
        "SDDDD.........B....D.........DSSSSS..........DDDD..SSSDDD.....HDDDDDS..........SSSDDD......BB........SSSSDSSSSSSSLLLLSSS",
        "SDDDDH...DSDDSSD.............DDSSS>.........<DDD.....SSDDDDDDDDDDDDDS..........SSSDD...DDDSSSSSS.....SDSDDLLLSSLSSLLLSSS",
        "SDDDDD....DDDDDD.............DDDSSS.....SSS...DDD.....S.DDDDDDDDDD......SSSSD.SSSSDD.....DDDDDD......SSDDDLSLSLSSSSLLSSS",
        "SDDDDDD....DDD...............DDDDSSS>...SLS...DDD..........DDDDDDD.......DDD..SSSSDD......DDDD.......SSDDDSSSSSSSSSSLSSS",
        "SDDDDDDH....D.................DDDDDSSS..SLLS..<DDD..............DD........D...SSSSDD........DD.......SDDDDSS..SS..SLLSSS",
        "S.DDDDDD.......................DDDDDDS...SLS...DDD...........................SSSDDDD.................SDDDSS...SS.SSLLSSS",
        "S..DDDDDDH......................DDDDDS...SLLS..DDDH.................SSSSSD...SSSDDD.................SSSSS.........LLSSSS",
        "S...DDDDDDD..............BB......DDDDD>...SLLS..DDD..................DDSDD...SSDDDD................SD............LLSSSSS",
        "SSSS..DDDDDDD......DDSSDSSS........DDDD....SLS..<DDDD.S..SSSSS........DDD....SDDDDD.............................LLSSLSSS",
        "SSSSSS.DDDDDDD......DDDDDDD.........DDDLLLLSLSLLLLDDDDSSSSDSSS..............SDDDD.............................LLLSSLSSSS",
        "SSSSSS...DDDDDH.......DDD............DDDLLLLLLLLSSSDDDDDDDDDSSSSSSS.........SDDD...........................S.LLSSLSSSS.S",
        "S.SSSSS.SSSDDDDD.......D...............DDSSLLLSSS....DDDDDDDDDDSSDSS......DDDDD...................D.DDSS..SSLLSSLLSSS..S",
        "S.SSSSSSS.SDDDDDDDDDH...................DSSSSSS.........DDDDDDDDDDD.DDD..HDDDD.................DDSDSSLLSSLLLLSSSSSSS..DS",
        "S..SLSSSSSS..DDDDDDDDDSS..SS............SS..................DDDDDDDDDDDDDDDDDD................DDDSLLSSSSSLSLLS...SS.HHDS",
        "S.SSSSSSSSSSSSDDDDDDDDSSSD.SS....................................DDDDDDDDDDDD.............SSSSSSSSSSSSSLLSLLSSSSSS..DDDS",
        "S.SSSLSSLLLSSS..DDDDDDDSDSDDDSS................SSSSSSSS.............DD................SS.SSSSSSDS...SSLLLLLS.SS....DDDDS",
        "SDD.SSSSSSLLSSSS.DDDDDDSSSSSSSSSSS....S.......SSSSSSSDDDH...........................SSSSSSSSSS..SS.SSSSSSLL..S..HDDDDDDS",
        "SDDS.SSS.SSSSS.S..DDDDDDDDDDDDDSSSSSSSSSS.S.SSSSSSDDDDDDDDDDDDD.............HDDDDSSSSDSSSSDDD....S.SS.SSSLLL.S.HDDDDDDDS",
        "SDDDD.......S.......DDDDDDDDDDDDSSSSSSSSSSSSSSSSDDDDDDDDDDDDDDDDDDDDDDDDDDDDDDDDDSDDDDDDD........SS.S..SSSLLL..DDDDDDDSS",
        "BBBBBBBBBBBBBBBBBBBBBBBBBBBBBBBBBBBBBBBBBBBBBBBBBBBBBBBBBBBBBBBBBBBBBBBBBBBBBBBBBBBBBBBBBBBBBBBBBBBBBBBBBBBBBBBBBBBBBBBB"
    ],
    "objects": [
        {
            "type": "AK47",
            "pos": [
                10,
                20
            ]
        },
        {
            "type": "Spawn",
            "pos": [
                59,
                20
            ]
        }
    ],
    "version": 2
}