{
    "size": [
        120,
        40
    ],
    "blocks": [
        "SSSSSSSSSSSSSSSSSSSSSSSSSSSSSSSSSSSSSSSSSSSSSSSSSSSSSSSSSSSSSSSSSSSSSSSSSSSSSSSSSSSSSSSSSSSSSSSSSSSSSSSSSSSSSSSSSSSSSSSS",
        "S..SSLSSS.......DDDDDDDDDDD..SSLLLSSSS......DDDDDDDDDDDDDDDDDDDDDDDDDDDDDDDDDDDDDDDDDDDDDDDDDDD........SSSSS....DDDDDDDS",
        "S.SSSSSLSSS..DDDDDDDDDSS....SSSSLSSSSSDDDDDDDDDDDDDDDDDDDDDDDDDDDDDDDDDDD......DDDDDDDDDDDDDDDDDD......SSS.......DDDDDDS",
        "S.SLLSSSS..DDDDDDDDDDS.......SSSSSSS..DDDDDDDDDDDSSSSSSDDDDDDDDDDDDDDDDD................DDDDDDDDDDD..SSS............DDDS",
        "S.SLSSSS..DDDDDDDDDSSS....C.SSSSSSS.DDDDDDDDDDDSSS...............DDDDDDDDD.DD...............DDDDDDSSSSS..............DDS",
        "S.SLSSSSSDSSDDDDDDSSS.......S......DDDDDDSSSSSSSS....................DDDDDDDDH................DDSSSSSD......S.........DS",
        "SSSLSSSDSSSSDDDDDS.SSSSS.........HDDDDDSSSSSSS..........H...............DDDDDD.................SDDDDD.....SSSS.........S",
        "SLSSSLDDSDDD.DDDSSSSS.SSSSSSS...DDDDSSSSSSS..........H.DDDD....H...........DDDDD...............D.........SSLSS.......SSS",
        "SLSSSLDDDDDDDDD.S..S.....SSSSSSSSSSSSSSS............DDDDDDDDDDDDDH...........DDD.....DDSSSSD...........SSSLLLSS......SSS",
        "SSSSLLDDSSD...SSS...........SSSSSSSSS.............DDDDDDD.DDD.DDDDD...........DDD.....DDDDD...........SSSSSSLSS....SSSSS",
        "SS.SSSDDDSD.D..S.............SSS................SSDDD.DD........DDDD.S.........DDD......D.........SSSSDDD.SSSS....SSSS.S",
        "S.H.DSDDDDD....................................SSDDD..............DDDSS.........DDD............SSS.SDDSDD..SSS....S.S.SS",
        "S.DDDSSDDD.....................................SDDD...............DDDSSS........DDD..................DDDDD...S.ESSSSS.SS",
        "SD.DDDDDDD...................................SSSDD.................DDDSSS........DDH.................<DDDDDH..SSSSSSSSSS",
        "S.D.DDDD...............SSSS..................SSDD.......DDDDDD.....DDDSSS.......SDDD..................DDDDDD..SSLLLLSSSS",
        "SDDDDDDD...............VS...SSS............SSSSDD.....HDDDLLDD....DDDDSSS.......SDDD..................SDDDDD..SSLLLLLSSS",
        "SDDDDDD.........H............SSS.........SSSSSSD......DDDDDDDD....DDDDSS........SDDDH..................SDDDD..SLLLLLLSSS",
        "SDDDDD.........DDDSSSDD......DSSS........SSSSSSD....HDDD.DDDD.....DDDDSS........SDDDD..................SDDSSS.SLLLLLLLSS",
        "SDDDDD...........DDDDD.......DSSSS......SSSS..DD...HDDD...........DDDSSS.......SSSDDD.................<SDSSSS.SLLLLLLLSS",
        "SDDDD..............D.........DSSSSS.....S....HDD...SDDDDH........DDDDS.........SSSDDD.................SSSDLSLSSSLLLLLLSS",
        "SDDDD.........B..............DSSSSS..........DDD...SSSDDD.....H.DDDDS..........SSSDDD......B.........SSSSDSSSSSSSLLLLSSS",
        "SDDDD....DSDDSSD.............DDSSS>.........<DDDH....SSDDDDDDDDDDDDDS..........SSSDD...DDDSSSSSS.....SDSDDLLLSSLSSLLLSSS",
        "SDDDDH....DDDDDD.............DDDSSS.....SSS...DDD.....S.DDDDDDDDDD............SSSSDD.....DDDDDD......SSDDDLSLSLSSSSLLSSS",
        "SDDDDD.....DDD...............DDDDSSS>...SLS...DDD..........DDDDDDD.......DDD..SSSSDD......DDDD.......SSDDDSSSSSSSSSSLSSS",
        "SDDDDD......D.................DDDDDSSS..SLLS..<DDD..............DD........D...SSSSDD........DD.......SDDDDSS..SS..SLLSSS",
        "S.DDDDDH.......................DDDDDDS...SLS...DDD...........................SSSDDDD.................SDDDSS...SS.SSLLSSS",
        "S..DDDDD........................DDDDDS...SLLS..DDDH..........................SSSDDD.................SSSSS.........LLSSSS",
        "S...DDDDDH...............BB......DDDDD>...SLLS..DDD..................DDSDD...SSDDDD................SD............LLSSSSS",
        "SSSS..DDDDD........DDSSDSSS........DDDD....SLS..<DDDD................VDDD....SDDDDD.............................LLSSLSSS",
        "SSSSSS.DDDDDDD......DDDDDDD.........DDDLLLLSLSLLLLDDDDSSSSDSSS..............SDDDD..........................B..LLLSSLSSSS",
        "SSSSSS...DDDDDH.......DDD............DDDLLLLLLLLSSSDDDDDDDDDSSSSSSS.........SDDD...........................S.LLSSLSSSS.S",
        "S.SSSSS.SSSDDDDD.......D...............DDSSLLLSSS....DDDDDDDDDDSSDSS......DDDDD.................DDD.DDSS..SSLLSSLLSSS..S",
        "S.SSSSSSS.SDDDDDDDDDH...................DSSSSSS.........DDDDDDDDDDD.DDD..HDDDD.................DDSDSSLLSSLLLLSSSSSSS..DS",
        "S..SLSSSSSS..DDDDDDDDDSS..SS............SS..................DDDDDDDDDDDDDDDDDD................DDDSLLSSSSSLSLLS...SS.HHDS",
        "S.SSSSSSSSSSSSDDDDDDDDSSSD.SS....................................DDDDDDDDDDDD.............SSSSSSSSSSSSSLLSLLSSSSSS..DDDS",
        "S.SSSLSSLLLSSS..DDDDDDDSDSDDDSS.....................................DD................SS.SSSSSSDS...SSLLLLLS.SS....DDDDS",
        "SDD.SSSSSSLLSSSS.DDDDDDSSSSSSSSSSS...............SSSSDDDH...........................SSSSSSSSSS..SS.SSSSSSLL..S..HDDDDDDS",
        "SDDS.SSS.SSSSS.S..DDDDDDDDDDDDDSSSSSSSSSS.S.SSSSSSDDDDDDDDDDDDD.............H...DSSSSDSSSSDDD....S.SS.SSSLLL.S.HDDDDDDDS",
        "SDDDD.......S.......DDDDDDDDDDDDSSSSSSSSSSSSSSSSDDDDDDDDDDDDDDDDDDDDDDDDDDDDDDDDDSDDDDDDD........SS.S..SSSLLL..DDDDDDDSS",
        "BBBBBBBBBBBBBBBBBBBBBBBBBBBBBBBBBBBBBBBBBBBBBBBBBBBBBBBBBBBBBBBBBBBBBBBBBBBBBBBBBBBBBBBBBBBBBBBBBBBBBBBBBBBBBBBBBBBBBBBB"
    ],
    "objects": [
        {
            "type": "AK47",
            "pos": [
                10,
                20
            ]
        },
        {
            "type": "Spawn",
            "pos": [
                59,
                19
            ]
        }
    ],
    "version": 2
}