36 86
SSSSSSSSSSSSSSSSSSSSSSSSSSSSSSSSSSSSSSSSSSSSSSSSSSSSSSSSSSSSSSSSSSSSSSSSSSSSSSSSSSSSSS
S....................................................................................S
S....................................................................................S
S....................................................................................S
S....................................................................................S
S....................................................................................S
S....................................................................................S
S....................................................................................S
S....................................................................................S
S....................................................................................S
S....................................................................................S
S....................................................................................S
S....................................................................................S
S....................................................................................S
S....................................................................................S
S....................................................................................S
S....................................................................................S
S....................................................................................S
S....................................................................................S
S.................................P..................................................S
S...............................S.D.D................................................S
S...............................SSSSS................................................S
S................................S.S.................................................S
S..............................................S...........................S.........S
S.............................................SSS..........................S.........S
S............................................SSSSS.........................S.........S
SDDDDD......................................SSSSSSS........................S.........S
SDDDDDD....................................SSSSSSSSS.......................S......E..S
SDDDDDDDDDDDDDDD.B.DDDDDDDDDDDDDDDDDDDDDDDDDDDDDDDDDDDDDDDDD...DDDDDDDDDDDDDDDDDDDDDDS
SSDDDDDDDDDDDDDDDDDDDDDDDDDDDDDDDDDDDDDDDDDDDDDDDDDSSSSSSSSS...SSSSSSSSSSSSSSSSSSSSSSS
SSSDDDDDDDDDDDDDDDDDDDDDDDDDDDDDDDDDDDDDDDDDDDDDDDDSSSSSSSSS...SSSSSSSSSSSSSSSSSSSSSSS
SSSSSSSDDDDDDDDDDDDDDDDDDDDDDDDDDDDDDDDDDDDDDDSSSSSSSSSSSSSS...SSSSSSSSSSSSSSSSSSSSSSS
SSSSSSSSSSSSSSDDDDDDDDSSSSSSSDDDDDDDDDDDDDDSSSSSSSSSSSSSSSSS...SSSSSSSSSSSSSSSSSSSSSSS
SSSSSSSSSSSSSSSSDDDSSSSSSSSSSSSSSDDDDSSSSSSSSSSSSSSSSSSSSSSS...SSSSSSSSSSSSSSSSSSSSSSS
SSSSSSSSSSSSSSSSSDSSSSSSSSSSSSSSSSDDSSSSSSSSSSSSSSSSSSSSSSSS...SSSSSSSSSSSSSSSSSSSSSSS
BBBBBBBBBBBBBBBBBBBBBBBBBBBBBBBBBBBBBBBBBBBBBBBBBBBBBBBBBBBBBBBBBBBBBBBBBBBBBBBBBBBBBB